lemma	gender
ААВО	мр
ААМИР	мр
АБА	мр
АБАБАКАР	мр
АБАБАКИР	мр
АБАД	мр
АБАЗЕР	мр
АБАЙ	мр
АБАКАР	мр
АБАКУМ	мр
АБАС	мр
АБАСАЛИ	мр
АБАСИ	жр
АБАТ	мр
АББАС	мр
АББАСАЛИ	мр
АББОС	мр
АББЯС	мр
АБГАР	мр
АБДАЛ	мр
АБДАЛА	мр
АБДАЛАХ	мр
АБДАЛЛА	мр
АБДАЛЛАХ	мр
АБДАРАХМАН	мр
АБДЕЛ	мр
АБДЕЛАЗИЗ	мр
АБДЕЛАЛИ	мр
АБДЕЛИЛАХ	мр
АБДЕЛКАДЕР	мр
АБДЕЛКРИМ	мр
АБДЕЛЛАТИФ	мр
АБДЕЛЛАХ	мр
АБДЕЛРАХМАН	мр
АБДЕЛЬ	мр
АБДЕЛЬ-НАСИР	мр
АБДЕЛЬАЗИЗ	мр
АБДЕЛЬБАСЕТ	мр
АБДЕЛЬКАБИР	мр
АБДЕЛЬКАДЕР	мр
АБДЕЛЬКАРИМ	мр
АБДЕЛЬКРИМ	мр
АБДЕЛЬМАЖИД	мр
АБДЕЛЬМАЛЕК	мр
АБДЕЛЬРАХИМ	мр
АБДЕЛЬРАХМАН	мр
АБДЕЛЬСАЛАМ	мр
АБДЕЛЬТИФ	мр
АБДЕЛЬХАДИ	мр
АБДЕЛЬХАК	мр
АБДЕЛЬХАКИМ	мр
АБДЕЛЬХАЛИМ	мр
АБДЕЛЬХАМИД	мр
АБДЕНБИ	мр
АБДЕНУР	мр
АБДЕРРАЗАК	мр
АБДЕРРАЗЗАК	мр
АБДЕРРАХИМ	мр
АБДЕРРАХМАН	мр
АБДЕРРЕЗАК	мр
АБДЕСЛАМ	мр
АБДЕССАМАД	мр
АБДЖАЛИЛ	мр
АБДИ	мр
АБДИБЕК	мр
АБДИВАЛИ	мр
АБДИГАНИ	мр
АБДИЖАЛИЛ	мр
АБДИКАДИР	мр
АБДИКАРИМ	мр
АБДИЛАЗИЗ	мр
АБДИЛАМИТ	мр
АБДИЛЛА	мр
АБДИЛЬДИН	мр
АБДИМАЖИТ	мр
АБДИМАЛИК	мр
АБДИН	мр
АБДИРАЗАК	мр
АБДИРАИМ	мр
АБДИРАЙИМ	мр
АБДИРАХМАН	мр
АБДИРАШИД	мр
АБДИРАШИТ	мр
АБДИСАМАТ	мр
АБДИСАТТОР	мр
АБДИШ	мр
АБДО	мр
АБДРАИМ	мр
АБДРАКИМ	мр
АБДРАМАН	мр
АБДРАУФ	мр
АБДРАХИМ	мр
АБДРАХМАН	мр
АБДРАШИТ	мр
АБДРЕФИЙ	мр
АБДРЕШИТ	мр
АБДРЯХИМ	мр
АБДУ	мр
АБДУАЛИМ	мр
АБДУБАСИР	мр
АБДУБАСИТ	мр
АБДУВАИТ	мр
АБДУВАЙТ	мр
АБДУВАКИЛ	мр
АБДУВАЛИ	мр
АБДУВАХАБ	мр
АБДУВАХИД	мр
АБДУВАХИТ	мр
АБДУГАМИД	мр
АБДУГАНИ	мр
АБДУГАПАР	мр
АБДУГАППАР	мр
АБДУГАФАР	мр
АБДУГАФОР	мр
АБДУГАФФАР	мр
АБДУДЖАБОР	мр
АБДУДЖАЛИЛ	мр
АБДУЖАБАР	мр
АБДУЖАББАР	мр
АБДУЖАББОР	мр
АБДУЖАБОР	мр
АБДУЖАЛИЛ	мр
АБДУЖАЛИЯ	жр
АБДУЖАМИЛ	мр
АБДУЖЕЛИЛ	мр
АБДУКАДИР	мр
АБДУКАДЫР	мр
АБДУКАИМ	мр
АБДУКАРИМ	мр
АБДУКАХОР	мр
АБДУКАЮМ	мр
АБДУКЕРИМ	мр
АБДУКИБОР	мр
АБДУКОДИР	мр
АБДУКОДЫР	мр
АБДУЛ	мр
АБДУЛ-АЗИЗ	мр
АБДУЛ-АЗИМ	мр
АБДУЛ-БАСИР	мр
АБДУЛ-ГАНИ	мр
АБДУЛ-ДЖАФАР	мр
АБДУЛ-КАДИР	мр
АБДУЛ-КАДЫР	мр
АБДУЛ-КАМАЛ	мр
АБДУЛ-КАЮМ	мр
АБДУЛ-МАЖИД	мр
АБДУЛ-САЛАМ	мр
АБДУЛ-ФАТАХ	мр
АБДУЛ-ХАК	мр
АБДУЛ-ШЕЙХ	мр
АБДУЛА	мр
АБДУЛАБЕК	мр
АБДУЛАДЖАН	мр
АБДУЛАЖАН	мр
АБДУЛАЖОН	мр
АБДУЛАЗИЗ	мр
АБДУЛАЗИС	мр
АБДУЛАЗЯН	мр
АБДУЛАИМ	мр
АБДУЛАЙ	мр
АБДУЛАЛИ	мр
АБДУЛАЛИМ	мр
АБДУЛАМИД	мр
АБДУЛАМИТ	мр
АБДУЛАН	мр
АБДУЛАСИР	мр
АБДУЛАТИВ	мр
АБДУЛАТИФ	мр
АБДУЛАХ	мр
АБДУЛАХАД	мр
АБДУЛАХАЙ	мр
АБДУЛАХАН	мр
АБДУЛАХАТ	мр
АБДУЛБАГИ	мр
АБДУЛБАРИ	мр
АБДУЛБАРИЙ	мр
АБДУЛБАСИР	мр
АБДУЛБАСИТ	мр
АБДУЛБАШ	мр
АБДУЛБАШИР	мр
АБДУЛВАГАБ	мр
АБДУЛВАХАП	мр
АБДУЛВАХЕД	мр
АБДУЛВАХОБ	мр
АБДУЛВЕЛИ	мр
АБДУЛГАДИ	мр
АБДУЛГАДИР	мр
АБДУЛГАЗИЗ	мр
АБДУЛГАМИД	мр
АБДУЛГАПУР	мр
АБДУЛГАФАР	мр
АБДУЛГАФУР	мр
АБДУЛГУСЕЙН	мр
АБДУЛДЖАЛИЛ	мр
АБДУЛЖАМИЛ	мр
АБДУЛЗАГИР	мр
АБДУЛКАДЕР	мр
АБДУЛКАДИР	мр
АБДУЛКАДЫР	мр
АБДУЛКАИР	мр
АБДУЛКАЙЮМ	мр
АБДУЛКАРАМ	мр
АБДУЛКАРИМ	мр
АБДУЛКАСИМ	мр
АБДУЛКАСИР	мр
АБДУЛКАФАР	мр
АБДУЛКАЮМ	мр
АБДУЛКЕРИМ	мр
АБДУЛКИРИМ	мр
АБДУЛКОДИР	мр
АБДУЛЛ	мр
АБДУЛЛА	мр
АБДУЛЛАГАДЖИ	мр
АБДУЛЛАЖАН	мр
АБДУЛЛАЗИЗ	мр
АБДУЛЛАТИФ	мр
АБДУЛЛАХ	мр
АБДУЛЛО	мр
АБДУЛЛОЖАН	мр
АБДУЛЛОЖОН	мр
АБДУЛЛЬ	мр
АБДУЛМАДЖИД	мр
АБДУЛМАЖИД	мр
АБДУЛМАЖИТ	мр
АБДУЛМАЛИК	мр
АБДУЛМАНАФ	мр
АБДУЛМАНОН	мр
АБДУЛМЕДЖИ	мр
АБДУЛМЕДЖИД	мр
АБДУЛМЕДЖИТ	мр
АБДУЛМЕЖИТ	мр
АБДУЛМЕЛИК	мр
АБДУЛМУМИН	мр
АБДУЛМУРОД	мр
АБДУЛМУСЛИМ	мр
АБДУЛМУТАЛИМ	мр
АБДУЛМУТАЛИН	мр
АБДУЛНАСИР	мр
АБДУЛНЕТИФ	мр
АБДУЛО	мр
АБДУЛПАТАХ	мр
АБДУЛРАГИМ	мр
АБДУЛРАЗАК	мр
АБДУЛРАХМАН	мр
АБДУЛРАШИД	мр
АБДУЛСАЛАМ	мр
АБДУЛСАЛИМ	мр
АБДУЛСЕЛИМ	мр
АБДУЛФАЗ	мр
АБДУЛХАДИР	мр
АБДУЛХАДЫР	мр
АБДУЛХАЕР	мр
АБДУЛХАИР	мр
АБДУЛХАЙ	мр
АБДУЛХАЙЛ	мр
АБДУЛХАК	мр
АБДУЛХАКИМ	мр
АБДУЛХАЛИК	мр
АБДУЛХАЛИМ	мр
АБДУЛХАМЕД	мр
АБДУЛХАМИД	мр
АБДУЛХАМИТ	мр
АБДУЛХАН	мр
АБДУЛХАТ	мр
АБДУЛХАХ	мр
АБДУЛЬ	мр
АБДУЛЬБЕР	мр
АБДУЛЬВАХИД	мр
АБДУЛЬРАХМАН	мр
АБДУЛЬФАЗ	мр
АБДУЛЬХАДИ	мр
АБДУЛЯР	мр
АБДУМАДЖИТ	мр
АБДУМАЖИД	мр
АБДУМАЖИТ	мр
АБДУМАЛИК	мр
АБДУМАННОБ	мр
АБДУМАНОН	мр
АБДУМУТАЛ	мр
АБДУМУТАЛИП	мр
АБДУНАБИ	мр
АБДУНАЗАР	мр
АБДУНАСИР	мр
АБДУНОСИР	мр
АБДУОЛИМ	мр
АБДУР	мр
АБДУРАГИМ	мр
АБДУРАЗАК	мр
АБДУРАЗЗАК	мр
АБДУРАЗОК	мр
АБДУРАИМ	мр
АБДУРАКИБ	мр
АБДУРАМАН	мр
АБДУРАСУЛ	мр
АБДУРАУФ	мр
АБДУРАФИ	мр
АБДУРАХИБ	мр
АБДУРАХИМ	мр
АБДУРАХИН	мр
АБДУРАХМАН	мр
АБДУРАХМОН	мр
АБДУРАШИД	мр
АБДУРАШИТ	мр
АБДУРЕФИ	жр
АБДУРЕШИТ	мр
АБДУРМАН	мр
АБДУРОХМОН	мр
АБДУРРАУФ	мр
АБДУСАЛА	жр
АБДУСАЛАМ	мр
АБДУСАЛОМ	мр
АБДУСАЛЬ	мр
АБДУСАМАТ	мр
АБДУСАМИ	мр
АБДУСАТАР	мр
АБДУСАТТАР	мр
АБДУСАТТОР	мр
АБДУСЕЛИМ	мр
АБДУССАТАР	мр
АБДУССАТОР	мр
АБДУХАБИБ	мр
АБДУХАКИМ	мр
АБДУХАЛИК	мр
АБДУХАЛИЛ	мр
АБДУХАЛИМ	мр
АБДУХАЛЫК	мр
АБДУХАМИД	мр
АБДУХАНОН	мр
АБДУХОЛИК	мр
АБДЫ	мр
АБДЫКАЮМ	мр
АБДЫЛБАР	мр
АБДЫЛДАБЕК	мр
АБДЫЛХАК	мр
АБЕД	мр
АБЕДИН	мр
АБЕЗ	мр
АБЕЛ	мр
АБЕЛИ	мр
АБЕЛИЙ	мр
АБЕЛЬ	мр
АБЕН	мр
АБЕСАЛОМ	мр
АБЕСАЛОМИ	мр
АБЕТ	мр
АБЖАЛОЛ	мр
АБЗАЛ	мр
АБЗАЛБЕК	мр
АБЗАЛДИН	мр
АБЗАЛТДИН	мр
АБЗАЛУТДИН	мр
АБЗАР	мр
АБИ	мр
АБИБ	мр
АБИБА	мр
АБИБЕ	жр
АБИБУЛА	мр
АБИБУЛАХ	мр
АБИБУЛЛА	мр
АБИГЕЙЛЬ	жр
АБИД	мр
АБИДА	мр
АБИДАТ	мр
АБИДИН	мр
АБИДУЛА	мр
АБИДУЛЛА	мр
АБИК	мр
АБИЛ	мр
АБИЛЖОН	мр
АБИЛИЙ	мр
АБИЛКАСИМ	мр
АБИЛФАЗ	мр
АБИЛФАТ	мр
АБИЛХАИР	мр
АБИЛЬ	мр
АБИЛЬВАН	мр
АБИЛЬВАП	мр
АБИЛЬДА	жр
АБИЛЬФАС	мр
АБИЛЬФАТ	мр
АБИСАЛ	мр
АБИСАЛОМ	мр
АБИТ	мр
АБИШ	мр
АБКАДЕР	мр
АБКАР	мр
АБКЕРИМ	мр
АБЛА	мр
АБЛАЗИЗ	мр
АБЛАЙ	мр
АБЛАКУЛ	мр
АБЛЕМИТ	мр
АБЛЕС	мр
АБЛОКУЛ	мр
АБЛЯЗ	мр
АБЛЯЗИЗ	мр
АБЛЯЗИС	мр
АБЛЯЙ	мр
АБЛЯКИМ	мр
АБЛЯМИД	мр
АБЛЯМИТ	мр
АБЛЯС	мр
АБО	мр
АБОВ	мр
АБОЛФАЗЛ	мр
АБОНИД	мр
АБРААМ	мр
АБРАГАМ	мр
АБРАЙ	мр
АБРАМ	мр
АБРАР	мр
АБРАТ	мр
АБРАХАМ	мр
АБРАХИМ	мр
АБРАХМАН	мр
АБРАШ	мр
АБРАШИТ	мр
АБРИК	мр
АБРИНА	жр
АБРОР	мр
АБРОРБЕК	мр
АБРОСИМ	мр
АБСАИД	мр
АБСАЛУДИН	мр
АБСАЛЯМ	мр
АБСАТТАР	мр
АБСЕЛИМ	мр
АБУ	мр
АБУ-СУПЬЯН	мр
АБУ-ХАСАН	мр
АБУБАКАР	мр
АБУБАКЕР	мр
АБУБАКИР	мр
АБУБАКР	мр
АБУБЕКЕР	мр
АБУБЕКИР	мр
АБУД	мр
АБУДАР	мр
АБУДИН	мр
АБУЕЗИТ	мр
АБУЗАГИР	мр
АБУЗАР	мр
АБУЗАРЬ	жр
АБУЗЕД	мр
АБУЗЕР	мр
АБУЗЯР	мр
АБУКАР	мр
АБУЛ	мр
АБУЛА	мр
АБУЛГАНИ	мр
АБУЛЛА	мр
АБУЛФАЗ	мр
АБУЛФАС	мр
АБУЛФАТ	мр
АБУЛХАСИМ	мр
АБУЛЬДЕР	мр
АБУЛЬФАЗ	мр
АБУЛЬФАРЗ	мр
АБУЛЬФАТ	мр
АБУМЕСЛИМ	мр
АБУМИСЛИМ	мр
АБУМУСЛИМ	мр
АБУМУСЛИН	мр
АБУРАШИД	мр
АБУСАЛАМ	мр
АБУСАТ	мр
АБУСУПЬЯН	мр
АБУТАЛИ	мр
АБУТАЛИБ	мр
АБУТАЛИП	мр
АБУШ	мр
АБУЯЗИТ	мр
АБХАЙ	мр
АБХИДЖИТ	мр
АБХИНАВ	мр
АБХИШЕК	мр
АБЫЛКАСЫМ	мр
АБЫЛЬ	мр
АБЫТ	мр
АБЫШ	мр
АБЯС	мр
АВА	мр
АВАГ	мр
АВАГИМ	мр
АВАД	мр
АВАДИЙ	мр
АВАЗ	мр
АВАЗБЕК	мр
АВАЗХАН	мр
АВАК	мр
АВАКУМ	мр
АВАМИЛЬ	мр
АВАН	мр
АВАНЕС	мр
АВАНИР	мр
АВАНТА	жр
АВАСХОН	мр
АВАТ	мр
АВАХ	мр
АВАХАНУМ	мр
АВВА	мр
АВВАКУМ	мр
АВГАИЛ	мр
АВГАН	мр
АВГЕНИЯ	жр
АВГОН	мр
АВГУСТА	жр
АВГУСТИН	мр
АВГУСТИНА	жр
АВДАЛ	мр
АВДАТ	мр
АВДЕЙ	мр
АВДИ	мр
АВДИЙ	мр
АВДИЛ	мр
АВДИШ	мр
АВДИЯ	жр
АВДО	мр
АВДОКИЯ	жр
АВДОТИЯ	жр
АВДОТЬЯ	жр
АВДЫШ	мр
АВЕГИК	мр
АВЕДИК	мр
АВЕДИС	мр
АВЕЗ	мр
АВЕЛ	мр
АВЕЛИ	мр
АВЕЛИЙ	мр
АВЕЛИНА	жр
АВЕЛИЯ	жр
АВЕЛЬ	мр
АВЕНАРИУС	мр
АВЕНЕР	мр
АВЕНИР	мр
АВЕНТИНА	жр
АВЕР	мр
АВЕРА	жр
АВЕРИЙ	мр
АВЕРКИЙ	мр
АВЕРЬЯН	мр
АВЕРЯН	мр
АВЕСАЛОМ	мр
АВЕТ	мр
АВЕТА	жр
АВЕТИК	мр
АВЕТИН	мр
АВЕТИС	мр
АВЗАЛ	мр
АВЗАЛЬ	мр
АВИА	жр
АВИАТА	жр
АВИАТТА	жр
АВИВ	мр
АВИГДОР	мр
АВИГЕЯ	жр
АВИЕТА	жр
АВИЗАР	мр
АВИЙ	мр
АВИК	мр
АВИЛ	мр
АВИЛА	жр
АВИЛЬ	мр
АВИМ	мр
АВИНЕР	мр
АВИНИР	мр
АВИОНА	жр
АВИС	мр
АВИЭЗЕР	мр
АВИЭТА	жр
АВИЯ	жр
АВКСЕНТИЙ	мр
АВЛЕВТИНА	жр
АВЛЕКСАНДР	мр
АВЛЕНТИН	мр
АВЛЕНТИНА	жр
АВЛЕРИЙ	мр
АВЛИНА	жр
АВМАНДИЛ	мр
АВНИ	мр
АВО	мр
АВРААМ	мр
АВРАЛИЯ	жр
АВРАМ	мр
АВРАМИЙ	мр
АВРЕЛ	мр
АВРЕЛИЙ	мр
АВРЕЛИЯ	жр
АВРИК	мр
АВРОР	мр
АВРОРА	жр
АВРОСИМ	мр
АВРУМ	мр
АВСЕЙ	мр
АВСЕНТИЙ	мр
АВСИЙ	мр
АВСТАФИЙ	мр
АВТАИДИЛ	мр
АВТАНДИЙ	мр
АВТАНДИЛ	мр
АВТАНДИН	мр
АВТАНДИЯ	жр
АВТАР	мр
АВТЕЛИНА	жр
АВТЕНДИЛ	мр
АВТОЛИНА	жр
АВТОНДИЛ	мр
АВТОНДИЯ	жр
АВТОНОМ	мр
АВХАДИЙ	мр
АВХАТ	мр
АГА-АЛИ	мр
АГА-МАМЕД	мр
АГАБАБА	мр
АГАБАЛА	мр
АГАБЕК	мр
АГАВАРД	мр
АГАВЕРДИ	мр
АГАВНИ	мр
АГАВНИК	мр
АГАГУЛУ	мр
АГАГУСЕЙН	мр
АГАГЮЛЬ	жр
АГАДАДАШ	мр
АГАДАР	мр
АГАДАШ	мр
АГАДДИН	мр
АГАДЖАН	мр
АГАДЖАФАР	мр
АГАДЖУМА	жр
АГАДИЯ	жр
АГАЖАН	мр
АГАИРЗА	мр
АГАИСМАИЛ	мр
АГАЙ	мр
АГАКЕРИМ	мр
АГАКИШИ	мр
АГАКШИ	мр
АГАЛАР	мр
АГАЛИ	мр
АГАЛИНА	жр
АГАЛЫ	мр
АГАЛЯМ	мр
АГАМ	мр
АГАМАЛЫ	мр
АГАМАМЕД	мр
АГАМЕД	мр
АГАМЕРЗА	мр
АГАМИР	мр
АГАМИРЗА	мр
АГАММЕД	мр
АГАМОГЛАН	мр
АГАМУРАД	мр
АГАМУРАТ	мр
АГАМЫРАТ	мр
АГАНЕЗ	мр
АГАНЕС	мр
АГАНЕТА	жр
АГАНИК	мр
АГАНИЯ	жр
АГАП	мр
АГАПЕЯ	жр
АГАПИ	жр
АГАПИЙ	мр
АГАПИЯ	жр
АГАПЬЯ	жр
АГАРАГИМ	мр
АГАРВАЛ	мр
АГАРЗА	мр
АГАРИЗА	жр
АГАРИЙ	мр
АГАРИЯ	жр
АГАРОН	мр
АГАРОП	мр
АГАРЬЯ	жр
АГАС	мр
АГАСАД	мр
АГАСАЛИМ	мр
АГАСАФ	мр
АГАСИ	жр
АГАСИЙ	мр
АГАСИН	мр
АГАСИЯ	жр
АГАСТАН	мр
АГАСЫ	мр
АГАТА	жр
АГАФАНГЕЛ	мр
АГАФЕНА	жр
АГАФИЙ	мр
АГАФИЯ	жр
АГАФОН	мр
АГАФЬЯ	жр
АГАФЯ	жр
АГАХАН	мр
АГАШИРИН	мр
АГАЯР	мр
АГВАН	мр
АГГЕЙ	мр
АГГЮЛЬ	жр
АГДАС	мр
АГЕЙ	мр
АГЕК	мр
АГЕЛИНА	мр
АГЕН	мр
АГЕНИЙ	мр
АГЕР	мр
АГЗАМ	мр
АГЗАМУТДИН	мр
АГЗАН	мр
АГЗЯМ	мр
АГИ	мр
АГИВ	мр
АГИГАТ	мр
АГИДА	жр
АГИДЕЛЬ	жр
АГИЙ	мр
АГИК	мр
АГИЛ	мр
АГИЛЬ	мр
АГИЛЯ	жр
АГИНА	жр
АГИР	мр
АГИРАФ	мр
АГИС	мр
АГИТ	мр
АГИТА	жр
АГИФ	мр
АГИШИН	мр
АГИЯ	жр
АГИЯН	мр
АГЛАИДА	жр
АГЛАР	мр
АГЛАФИРА	жр
АГЛАЯ	жр
АГЛЕЯ	жр
АГЛИНА	жр
АГЛИУЛЛА	мр
АГЛИЯ	жр
АГЛЯ	жр
АГЛЯМ	мр
АГЛЯМЕТДИН	мр
АГЛЯМУТДИН	мр
АГМАД	мр
АГНДРЕЙ	мр
АГНЕ	жр
АГНЕЖКА	жр
АГНЕЗИЯ	жр
АГНЕС	жр
АГНЕСА	жр
АГНЕСИЯ	жр
АГНЕССА	жр
АГНЕССИЯ	жр
АГНЕТА	жр
АГНЕТТА	жр
АГНЕШ	жр
АГНЕША	жр
АГНЕЯ	жр
АГНИСИЯ	жр
АГНИЯ	жр
АГО	мр
АГОП	мр
АГОСИ	жр
АГОСТИНО	мр
АГОТА	жр
АГОФОН	мр
АГОФЬЯ	жр
АГРАДИНА	жр
АГРАН	мр
АГРАПИНА	жр
АГРАППИНА	жр
АГРАФЕНА	жр
АГРАФЕНИЯ	жр
АГРАФИНА	жр
АГРАФИНЬЯ	жр
АГРАФЬЯ	жр
АГРЕНИНА	жр
АГРЕПЕНА	жр
АГРЕПИНА	жр
АГРЕППИНА	жр
АГРЕС	мр
АГРЕТИНА	жр
АГРЕФЕНА	жр
АГРЕФИНА	жр
АГРИНИНА	жр
АГРИПЕНА	жр
АГРИПИНА	жр
АГРИПИННА	жр
АГРИППИНА	жр
АГРИС	мр
АГРИФЕНА	жр
АГРИФИНА	жр
АГРОПИНА	жр
АГРОФЕНА	жр
АГРОФИНА	жр
АГУБЕ	мр
АГУБЕКИР	мр
АГУДАС	мр
АГУН	мр
АГУНДА	жр
АГУНИК	мр
АГУРИЙ	мр
АГУСТИНА	жр
АГФИЯ	жр
АГХА	жр
АГШИН	мр
АДА	жр
АДАИДА	жр
АДАИЛ	мр
АДАИЛЬ	мр
АДАЙ	мр
АДАЛАИДА	жр
АДАЛАР	мр
АДАЛАТ	мр
АДАЛЕТ	мр
АДАЛИЙ	мр
АДАЛИНА	жр
АДАЛИЯ	жр
АДАЛЬ	мр
АДАЛЬБЕРТ	мр
АДАЛЬФИНА	жр
АДАЛЯ	жр
АДАЛЯТ	мр
АДАМ	мр
АДАМБАЙ	мр
АДАМУР	мр
АДАН	мр
АДАНИС	мр
АДАПЕТ	мр
АДАР	мр
АДАРЬЯ	жр
АДАС	мр
АДАСЬ	жр
АДБУЛЛАХ	мр
АДВАРД	мр
АДВАРТ	мр
АДГАМ	мр
АДГАН	мр
АДГАР	мр
АДГЕЗАЛ	мр
АДГЕМ	мр
АДДИ	мр
АДЕАЛИНА	жр
АДЕИНА	жр
АДЕЙЛЯ	жр
АДЕКСЕЙ	мр
АДЕЛ	мр
АДЕЛА	жр
АДЕЛАИДА	жр
АДЕЛАИНА	жр
АДЕЛАЙДА	жр
АДЕЛАНДА	жр
АДЕЛИ	жр
АДЕЛИАДА	жр
АДЕЛИДА	жр
АДЕЛИЙ	мр
АДЕЛИН	жр
АДЕЛИНА	жр
АДЕЛИЯ	жр
АДЕЛКА	жр
АДЕЛЛА	жр
АДЕЛОИДА	жр
АДЕЛЬ	жр
АДЕЛЬВИНА	жр
АДЕЛЬГЕЙДА	жр
АДЕЛЬЖАН	мр
АДЕЛЬЗЯН	мр
АДЕЛЬМИНА	жр
АДЕЛЬМУРЗИН	мр
АДЕЛЬФИНА	жр
АДЕЛЬХАН	мр
АДЕЛЬША	жр
АДЕЛЬШАН	мр
АДЕЛЬЯ	жр
АДЕМ	мр
АДЕМЕЙ	мр
АДЕМИЯ	жр
АДЕНА	жр
АДЕРМИ	жр
АДЕРША	жр
АДЕС	мр
АДЕХАМ	мр
АДЕШ	мр
АДЕЯ	жр
АДЖАЙ	мр
АДЖАМ	мр
АДЖАР	мр
АДЖАТ	мр
АДЖЕЙ	мр
АДЖЕР	мр
АДЖИ	мр
АДЖИМИР	мр
АДЖИМУРАТ	мр
АДЖИРЕ	мр
АДЖИТ	мр
АДЖИХАЛИЛ	мр
АДЖМАЛ	мр
АДИ	мр
АДИАЛИДА	жр
АДИАН	мр
АДИБ	мр
АДИБА	жр
АДИБЕК	мр
АДИБЯ	жр
АДИГАМ	мр
АДИГАР	мр
АДИГЕЗАЛ	мр
АДИГОЗАЛ	мр
АДИЗ	мр
АДИЙ	мр
АДИК	мр
АДИЛ	мр
АДИЛ-ОГЛЫ	мр
АДИЛА	жр
АДИЛАГА	мр
АДИЛАИДА	жр
АДИЛБЕК	мр
АДИЛДЖАН	мр
АДИЛЖАН	мр
АДИЛЖОН	мр
АДИЛИНА	жр
АДИЛИЯ	жр
АДИЛКАН	мр
АДИЛХАН	мр
АДИЛШАХ	мр
АДИЛЬ	мр
АДИЛЬ-ГИРЕЙ	мр
АДИЛЬБЕК	мр
АДИЛЬГИРЕЙ	мр
АДИЛЬЖАН	мр
АДИЛЬХАН	мр
АДИЛЬЯ	жр
АДИМ	мр
АДИМИР	мр
АДИН	мр
АДИНА	жр
АДИНЕ	жр
АДИНЖАН	мр
АДИНЯ	жр
АДИП	мр
АДИПХАН	мр
АДИР	мр
АДИС	мр
АДИСА	жр
АДИСЕЙ	мр
АДИСЛАВ	мр
АДИТ	мр
АДИФ	мр
АДИШИРИН	мр
АДИЯ	жр
АДИЯТУЛЛА	мр
АДЛ	мр
АДЛАН	мр
АДЛИ	мр
АДЛИФА	жр
АДЛИФЕ	жр
АДЛИФЯ	жр
АДЛЫ	мр
АДМАН	мр
АДМИЛА	жр
АДМИЯ	жр
АДНАН	мр
АДОЛАИДА	жр
АДОЛАТ	мр
АДОЛЕТ	мр
АДОЛИЙ	мр
АДОЛИК	мр
АДОЛИНА	жр
АДОЛФ	мр
АДОЛЬ	мр
АДОЛЬФ	мр
АДОЛЬФАС	мр
АДОЛЬФИНА	жр
АДОЛЯ	жр
АДОЛЯТ	мр
АДОМАС	мр
АДОН	мр
АДРЕЙ	мр
АДРИ	мр
АДРИАДА	жр
АДРИАН	мр
АДРИАНА	жр
АДРИАННА	жр
АДРИАНО	мр
АДРИАНУС	мр
АДРИЕН	мр
АДРИНА	жр
АДРИНЕ	жр
АДРИНЭ	жр
АДРИЯН	мр
АДРИЯНА	жр
АДУ	мр
АДУЛА	жр
АДУЛКАДЕР	мр
АДУРАХМАН	мр
АДХАМ	мр
АДХАМЖАН	мр
АДХАМЖОН	мр
АДЫ	мр
АДЫБЕК	мр
АДЫЙ	мр
АДЫЛ	мр
АДЫЛЖАН	мр
АДЫЛЬ	мр
АДЫЛЯ	жр
АДЫМ	мр
АДЫП	мр
АДЫР	мр
АДЫХАМ	мр
АДЫХАН	мр
АДЬГАМ	мр
АДЬЯ	жр
АДЬЯА	жр
АДЬЯМ	мр
АДЬЯН	мр
АДЭЛ	мр
АДЭЛА	жр
АДЭЛИНА	жр
АДЭЛИЯ	жр
АДЭЛЛА	жр
АДЭЛЬ	жр
АДЭЛЯ	жр
АЕАТОЛИЙ	мр
АЕДРЕЙ	мр
АЕЖЕЛА	жр
АЕЖЕЛИКА	жр
АЕЛИТА	жр
АЕРА	жр
АЕТА	жр
АЖА	жр
АЖАЙ	мр
АЖАР	мр
АЖАРКУЛЬ	жр
АЖДААК	мр
АЖДАР	мр
АЖЕЙРАН	мр
АЖЕЛА	жр
АЖЕЛИКА	жр
АЖЕЛИНА	жр
АЖЕМАК	мр
АЖИМ	мр
АЖИРЯ	жр
АЖМАМБЕТ	мр
АЗА	жр
АЗАД	мр
АЗАДА	жр
АЗАДАХАН	мр
АЗАДИ	мр
АЗАДУН	мр
АЗАЗЕЛЛО	мр
АЗАИДА	жр
АЗАЙ	мр
АЗАЛ	мр
АЗАЛИЙ	мр
АЗАЛИНА	жр
АЗАЛХАН	мр
АЗАЛШО	мр
АЗАМ	мр
АЗАМАТ	мр
АЗАМАТЖОН	мр
АЗАМБАЙ	мр
АЗАМДЖОН	мр
АЗАМЕТ	мр
АЗАМЖАН	мр
АЗАМЖОН	мр
АЗАР	мр
АЗАРИ	мр
АЗАРИЙ	мр
АЗАРИНА	жр
АЗАРИЯ	жр
АЗАРЯ	жр
АЗАТ	мр
АЗАТАН	мр
АЗАТБАЙ	мр
АЗАТУИ	мр
АЗАТХАН	мр
АЗАУХАН	мр
АЗАФ	мр
АЗГАМ	мр
АЗГАНУШ	жр
АЗГАР	мр
АЗГАТ	мр
АЗГУШ	мр
АЗЕ	мр
АЗЕДДИН	мр
АЗЕЛЛА	жр
АЗЕЛЬ	жр
АЗЕМ	мр
АЗЕМЕТ	мр
АЗЕР	мр
АЗЕТТА	жр
АЗЗА	жр
АЗЗАМ	мр
АЗИ	мр
АЗИДА	жр
АЗИЕВ	мр
АЗИЗ	мр
АЗИЗА	жр
АЗИЗАГА	мр
АЗИЗАМИ	мр
АЗИЗАХАН	мр
АЗИЗАХОН	мр
АЗИЗБЕК	мр
АЗИЗГЮЛЬ	жр
АЗИЗЕ	жр
АЗИЗЖОН	мр
АЗИЗИЛЛА	жр
АЗИЗКУЛ	мр
АЗИЗУЛА	жр
АЗИЗУЛЛА	мр
АЗИЗУЛЛО	мр
АЗИЗХОН	мр
АЗИЗЯ	жр
АЗИК	мр
АЗИЛИЯ	жр
АЗИЛЯ	жр
АЗИМ	мр
АЗИМА	жр
АЗИМБАЙ	мр
АЗИМДЖАН	мр
АЗИМДЖОН	мр
АЗИМЕ	жр
АЗИМЖАН	мр
АЗИМХАН	мр
АЗИМШО	мр
АЗИНА	жр
АЗИР	мр
АЗИС	мр
АЗИСА	жр
АЗИТ	мр
АЗМАН	мр
АЗМАТ	мр
АЗМЕТ	мр
АЗМИ	мр
АЗНАУР	мр
АЗНАФ	мр
АЗНИВ	мр
АЗНИФ	мр
АЗНЫВ	мр
АЗО	мр
АЗОДА	жр
АЗОЛЬДА	жр
АЗОМАТ	мр
АЗОР	мр
АЗРЕТ	мр
АЗРЕТ-АЛИ	мр
АЗРИЕЛЬ	мр
АЗРИЛЬ	мр
АЗРИЭЛЬ	мр
АЗУЛЛА	мр
АЗУЧЕНА	жр
АЗХАР	мр
АЗЫМ	мр
АЗЭР	мр
АЗЯ	жр
АЗЯР	мр
АИАНА	жр
АИВАЗ	мр
АИВАР	мр
АИВИР	мр
АИГУЛЬ	жр
АИДА	жр
АИДЕР	мр
АИДИ	мр
АИДЫН	мр
АИЗА	жр
АИЗОР	мр
АИЙ	мр
АИК	мр
АИКАЗ	мр
АИКТОР	мр
АИЛА	жр
АИЛАЗ	мр
АИЛИНА	жр
АИЛИТА	жр
АИЛИЯ	жр
АИМАН	мр
АИН	мр
АИНА	жр
АИНАРС	мр
АИНИ	мр
АИННА	жр
АИРА	жр
АИС	мр
АИСА	мр
АИСЕР	мр
АИСИЯ	жр
АИСЛУ	мр
АИСЯ	жр
АИТ	мр
АИТА	жр
АИТБАЙ	мр
АИТОНИНА	жр
АИША	жр
АЙАР	мр
АЙАРПИ	жр
АЙАСЕР	мр
АЙАСТАН	мр
АЙБАЛА	мр-жр
АЙБАНИЗ	мр
АЙБАР	мр
АЙБЕК	мр
АЙБЕНИЗ	мр
АЙБИКА	жр
АЙБУЛАТ	мр
АЙВАЗ	мр
АЙВАР	мр
АЙВАРАС	мр
АЙВАРС	мр
АЙВАС	мр
АЙВЕНГО	мр
АЙВИЗ	мр
АЙВИК	мр
АЙВИКА	жр
АЙВО	мр
АЙГАЗ	мр
АЙГАНУШ	мр
АЙГАР	мр
АЙГАРС	мр
АЙГЕРИМ	жр
АЙГИН	мр
АЙГОЗЕЛЬ	мр
АЙГУБ	мр
АЙГУЛ	мр
АЙГУЛЬ	жр
АЙГУЛЯ	жр
АЙГУН	мр
АЙГУШ	мр
АЙГЮЛЬ	жр
АЙГЮН	мр
АЙГЮНЬ	жр
АЙДАМИР	мр
АЙДАН	жр
АЙДАНА	жр
АЙДАР	мр
АЙДАРАЛИ	мр
АЙДАРБЕК	мр
АЙДАРХАН	мр
АЙДАС	мр
АЙДЕ	мр
АЙДЕМИР	мр
АЙДЕН	мр
АЙДЕР	мр
АЙДЖАМАЛ	мр
АЙДЖАН	мр
АЙДЖЕМАЛ	мр
АЙДИМИР	мр
АЙДИН	мр
АЙДИНА	жр
АЙДИНБЕК	мр
АЙДИР	мр
АЙДОГАН	мр
АЙДОГДЫ	мр
АЙДОС	мр
АЙДУК	мр
АЙДУМ	мр
АЙДУН	мр
АЙДЫК	мр
АЙДЫМ	мр
АЙДЫН	мр
АЙДЫНБЕК	мр
АЙДЫП	мр
АЙДЫР	мр
АЙЕД	мр
АЙЕР	мр
АЙЖАМАЛ	мр
АЙЖАН	жр
АЙЖАННА	жр
АЙЗА	жр
АЙЗАДА	жр
АЙЗАН	мр
АЙЗАНАТ	мр
АЙЗАТ	мр
АЙЗЕР	мр
АЙЗИК	мр
АЙЗУДИН	мр
АЙЗЫК	мр
АЙИСАТ	мр
АЙИШАТ	мр
АЙК	мр
АЙКА	жр
АЙКАЗ	мр
АЙКАЗУН	мр
АЙКАЙ	мр
АЙКАНДУХТ	мр
АЙКАНУШ	мр
АЙКАРАМ	мр
АЙКАРАН	мр
АЙКАС	мр
АЙКИЗ	мр
АЙКО	мр
АЙКУИ	мр
АЙКУН	мр
АЙКУТ	мр
АЙКУШ	мр
АЙКЮН	мр
АЙКЮНЬ	жр
АЙЛА	жр
АЙЛАЗ	мр
АЙЛЕН	мр
АЙЛИ	мр
АЙЛИН	мр
АЙЛИНЬ	жр
АЙЛИСА	жр
АЙЛИТА	жр
АЙМА	жр
АЙМАН	мр
АЙМАНИ	мр
АЙМАРА	жр
АЙМЕ	мр
АЙМЕН	мр
АЙМЕР	мр
АЙМИРА	жр
АЙМИСЕЙ	мр
АЙН	мр
АЙНА	жр
АЙНАГУЛ	мр
АЙНАГУЛЬ	жр
АЙНАГЮЛЬ	жр
АЙНАР	мр
АЙНАРА	жр
АЙНАРС	мр
АЙНАС	мр
АЙНАШ	жр
АЙНДИ	мр
АЙНЕ	жр
АЙНЕЛЬ	жр
АЙНЕР	мр
АЙНИ	мр
АЙНИДДИН	мр
АЙНИДИН	мр
АЙНИЖАН	мр
АЙНИСА	жр
АЙНИТДИН	мр
АЙНО	мр
АЙНОРА	жр
АЙНУДДИН	мр
АЙНУДИН	мр
АЙНУЛ	мр
АЙНУЛА	жр
АЙНУЛЛА	мр
АЙНУР	жр
АЙНУРА	жр
АЙНУТДИН	мр
АЙНЯ	жр
АЙО	мр
АЙПАРА	жр
АЙРАЗАТ	мр
АЙРАНЕТ	мр
АЙРАПЕТ	мр
АЙРАТ	мр
АЙРЕС	мр
АЙРИК	мр
АЙРИС	жр
АЙРО	мр
АЙСА	жр
АЙСАНА	жр
АЙСАР	мр
АЙСАРА	жр
АЙСАРАТ	мр
АЙСЕДОРА	жр
АЙСЕЛ	мр
АЙСЕЛУ	мр
АЙСЕЛЬ	жр
АЙСЕН	мр
АЙСЕР	мр
АЙСИЛУ	мр
АЙСЛА	жр
АЙСЛУ	жр
АЙСТАН	мр
АЙСУ	жр
АЙСУЛА	жр
АЙСУЛУ	жр
АЙСЫЛУ	мр
АЙСЫН	мр
АЙСЯ	жр
АЙСЯУ	жр
АЙТА	жр
АЙТАКИН	мр
АЙТАН	мр
АЙТАЧ	мр
АЙТЕ	мр
АЙТЕК	мр
АЙТЕМИР	мр
АЙТЕНЬ	жр
АЙТЖАН	мр
АЙТКАЛИ	мр
АЙТМАМАТ	мр
АЙТМУХАМЕД	мр
АЙТПАЙ	мр
АЙТУГАН	мр
АЙТЭН	мр
АЙТЯН	мр
АЙФЕР	мр
АЙХАЛ	мр
АЙХАМ	мр
АЙХАН	мр
АЙХУА	жр
АЙХУН	мр
АЙЦЕМНИК	мр
АЙЧАН	мр
АЙЧЖУН	мр
АЙША	жр
АЙШАН	мр
АЙШАТ	мр
АЙШАХАН	мр
АЙШАХОН	мр
АЙШЕ	жр
АЙШЕТ	мр
АЙШИ	жр
АЙЩЕ	мр
АЙЫГ	мр
АЙЮБ	мр
АЙЮБА	жр
АЙЯ	жр
АЙЯД	мр
АЙЯН	мр
АЙЯР	мр
АЙЯТ	мр
АК-БОЗАТ	мр
АКАБИР	мр
АКАВ	мр
АКАД	мр
АКАДИЙ	мр
АКАЙИМ	мр
АКАКИЙ	мр
АКАРИ	мр
АКАТЕРИНА	жр
АКАШ	мр
АКБАЛ	мр
АКБАЛА	мр-жр
АКБАР	мр
АКБАРАЛИ	мр
АКБАРИ	мр
АКБАРХАН	мр
АКБАРШО	мр
АКБЕК	мр
АКБЕР	мр
АКБИР	мр
АКБУЛАТ	мр
АКВЕР	мр
АКВИЛИНА	жр
АКГУЛЬ	жр
АКДЯС	мр
АКЕЛ	мр
АКЕЛИНА	жр
АКЕНДИН	мр
АКЕРКЕ	жр
АКЗАМ	мр
АКЗИБА	жр
АКИВ	мр
АКИВА	мр
АКИЙ	мр
АКИЛ	мр
АКИЛИНА	жр
АКИЛЬ	мр
АКИЛЯ	жр
АКИМ	мр
АКИМА	жр
АКИМБЕК	мр
АКИМДЖАН	мр
АКИМЕ	жр
АКИМЖАН	мр
АКИМЖОН	мр
АКИНА	жр
АКИНДИН	мр
АКИНОЛА	жр
АКИНОР	мр
АКИНФ	мр
АКИНФИЙ	мр
АКИО	мр
АКИП	мр
АКИР	мр
АКИФ	мр
АКИФА	жр
АКЙОЛ	мр
АККАКИЙ	мр
АККАЛИ	мр
АККУ	мр
АККУЛИНА	жр
АКЛИ	мр
АКЛИЛУ	жр
АКЛИМА	жр
АКЛИМЕ	жр
АКЛИМЯ	жр
АКЛИНА	жр
АКМ	мр
АКМАЛ	мр
АКМАЛЖАН	мр
АКМАЛЖОН	мр
АКМАЛЬ	мр
АКМАРАЛ	мр
АКМУРАД	мр
АКМУРАТ	мр
АКО	мр
АКОБ	мр
АКОБИР	мр
АКОН	мр
АКОП	мр
АКОПИК	мр
АКОШ	мр
АКПАР	мр
АКПЕР	мр
АКРАМ	мр
АКРАМБЕК	мр
АКРАМДЖАН	мр
АКРАМЖАН	мр
АКРАМЖОН	мр
АКРАМЗОН	мр
АКРАМУТДИН	мр
АКРАМХОН	мр
АКРАМХУЖА	мр
АКРЕМ	мр
АКРОМ	мр
АКРОМЖОН	мр
АКРЯМ	мр
АКСАН	мр
АКСАНА	жр
АКСАНДР	мр
АКСАНИЯ	мр
АКСЕЛ	мр
АКСЕЛЬ	жр
АКСЕН	мр
АКСЕНА	жр
АКСЕНИЙ	мр
АКСЕНИЯ	жр
АКСЕНТИЙ	мр
АКСЕНЬЯ	жр
АКСЕНЯ	жр
АКСИНА	жр
АКСИНИЯ	жр
АКСИНЬЯ	жр
АКСЛУ	мр
АКСОНА	жр
АКСЮТА	жр
АКТАВ	мр
АКТАВИАН	мр
АКТАВИЙ	мр
АКТАВИЯ	жр
АКТАМ	мр
АКТАР	мр
АКТЕБРИНА	жр
АКТЕМ	мр
АКТОВИАН	мр
АКУЛИНА	жр
АКУШЕВАН	мр
АКХИЛ	мр
АКХИЛЕШ	мр
АКЧУРА	жр
АКШИН	мр
АКЫ	мр
АКЫЛБЕК	мр
АКЫР	мр
АЛА	мр
АЛАА	мр
АЛАББАС	мр
АЛАБЕРГЕН	мр
АЛАБЕРДЫ	мр
АЛАВДИН	мр
АЛАВИ	мр
АЛАВСАТ	мр
АЛАГАР	мр
АЛАДАР	мр
АЛАДИН	мр
АЛАЕДДИН	мр
АЛАЗ	мр
АЛАИДА	жр
АЛАИЗА	жр
АЛАЙ	мр
АЛАЙБЕК	мр
АЛАКБЕР	мр
АЛАКСАНДРА	жр
АЛАМ	мр
АЛАМАН	мр
АЛАМГИР	мр
АЛАМДАР	мр
АЛАМЗАР	мр
АЛАН	мр
АЛАНА	жр
АЛАНАЗАР	мр
АЛАНБЕК	мр
АЛАНДАР	мр
АЛАНДИН	мр
АЛАННА	жр
АЛАНТИНА	жр
АЛАР	мр
АЛАСКАР	мр
АЛАУДИ	мр
АЛАУДИН	мр
АЛАУТДИН	мр
АЛАФИЯ	жр
АЛАХВЕРДИ	мр
АЛАХВЕРДЫ	мр
АЛАХМЕД	мр
АЛАЧКА	жр
АЛАШРАФ	мр
АЛАЯР	мр
АЛБАЛА	мр
АЛББЕРТ	мр
АЛББИНА	жр
АЛБЕГ	мр
АЛБЕК	мр
АЛБЕРТ	мр
АЛБИК	мр
АЛБИН	мр
АЛБИНА	жр
АЛБИР	мр
АЛБУРИ	мр
АЛБФИЯ	жр
АЛВАН	мр
АЛВАР	мр
АЛВАРА	жр
АЛВАРД	мр-жр
АЛВАРДА	жр
АЛВАРО	мр
АЛВАРТ	мр
АЛВЕРТ	мр
АЛВИАН	мр
АЛВИДА	жр
АЛВИК	мр
АЛВИН	мр
АЛВИНА	жр
АЛВИРА	жр
АЛВИС	мр
АЛВИЯН	мр
АЛГАМ	мр
АЛГАСАН	мр
АЛГАТ	мр
АЛГИМАНТАС	мр
АЛГИНА	жр
АЛГИРДАС	мр
АЛГИС	мр
АЛДА	мр
АЛДАБЕРГЕН	мр
АЛДАМ	мр
АЛДАР	мр
АЛДИНА	жр
АЛДИС	мр
АЛДИЯР	мр
АЛДОНА	жр
АЛДУЗ	мр
АЛЕАН	мр
АЛЕАНА	жр
АЛЕБАРЦУМ	мр
АЛЕВ	мр
АЛЕВА	жр
АЛЕВТАНА	жр
АЛЕВТИН	мр
АЛЕВТИНА	жр
АЛЕГ	мр
АЛЕГР	мр
АЛЕГТИНА	жр
АЛЕДДИН	мр
АЛЕДИ	мр
АЛЕДИН	мр
АЛЕДИЯ	жр
АЛЕЕКСАНДР	мр
АЛЕЗИЙ	мр
АЛЕЗИЯ	жр
АЛЕИНА	жр
АЛЕЙ	мр
АЛЕЙЗА	жр
АЛЕК	мр
АЛЕКАН	мр
АЛЕКАНДР	мр
АЛЕКАНДРА	жр
АЛЕКБАР	мр
АЛЕКБЕР	мр
АЛЕКЕЙ	мр
АЛЕКО	мр
АЛЕКПЕР	мр
АЛЕКС	мр
АЛЕКСА	жр
АЛЕКСАГДР	мр
АЛЕКСАЕДРА	жр
АЛЕКСАЙ	мр
АЛЕКСАН	мр
АЛЕКСАНА	жр
АЛЕКСАНД	мр
АЛЕКСАНДАРА	жр
АЛЕКСАНДЕР	мр
АЛЕКСАНДО	мр
АЛЕКСАНДОР	мр
АЛЕКСАНДР	мр
АЛЕКСАНДРА	жр
АЛЕКСАНДРАС	мр
АЛЕКСАНДРИНА	жр
АЛЕКСАНДРОС	мр
АЛЕКСАНДЭР	мр
АЛЕКСАНЕДРА	жр
АЛЕКСАС	мр
АЛЕКСЕЙ	мр
АЛЕКСЕН	мр
АЛЕКСЕНД	мр
АЛЕКСЕНДР	мр
АЛЕКСЕР	мр
АЛЕКСИ	жр
АЛЕКСИД	мр
АЛЕКСИЙ	мр
АЛЕКСИНА	жр
АЛЕКСИС	мр
АЛЕКСИЯ	жр
АЛЕКСНДР	мр
АЛЕКССА	жр
АЛЕКСТИНА	жр
АЛЕКСЧАНДР	мр
АЛЕКТИН	мр
АЛЕКТИНА	жр
АЛЕКТИОН	мр
АЛЕКУ	мр
АЛЕКШЕР	мр
АЛЕЛИЯ	жр
АЛЕМ	мр
АЛЕМАЙЕХУ	мр
АЛЕМПИАДА	жр
АЛЕМПИЙ	мр
АЛЕМПИНА	жр
АЛЕН	мр
АЛЁНА	жр
АЛЕННА	жр
АЛЕНТИЙ	мр
АЛЕНТИН	мр
АЛЕНТИНА	жр
АЛЕОДОР	мр
АЛЕОНОР	мр
АЛЕОНОРА	жр
АЛЕОРТИНА	жр
АЛЕРИЙ	мр
АЛЕРИНА	жр
АЛЕРИЯ	жр
АЛЕСА	жр
АЛЕСАНДР	мр
АЛЕСАНДРА	жр
АЛЕСЕЙ	мр
АЛЕСИЯ	жр
АЛЕСКАНДР	мр
АЛЕСКАНДРА	жр
АЛЕСКАР	мр
АЛЕСКЕР	мр
АЛЕССАНДРО	мр
АЛЕССИО	мр
АЛЕСТИНА	жр
АЛЕСЬ	мр
АЛЕСЬЯ	жр
АЛЕСЯ	жр
АЛЕТ	мр
АЛЕТА	мр
АЛЕТДИН	мр
АЛЕТИНА	жр
АЛЕТТА	жр
АЛЕУ	жр
АЛЕУКСАНДР	мр
АЛЕФИНА	жр
АЛЕФИРА	жр
АЛЕФТИН	мр
АЛЕФТИНА	жр
АЛЕХ	мр
АЛЕХАН	мр
АЛЕХАНДРА	жр
АЛЕХАНДРО	мр
АЛЕХОН	мр
АЛЕХТИНА	жр
АЛЕЧКА	жр
АЛЕШ	мр
АЛЁША	мр
АЛЕЯ	жр
АЛЖАНА	жр
АЛЖАНАТ	мр
АЛЖАНБЕК	мр
АЛЖБЕТА	жр
АЛИ	мр
АЛИ-АСКАР	мр
АЛИ-АСКЕР	мр
АЛИ-БЕК	мр
АЛИ-СУЛТАН	мр
АЛИА	жр
АЛИАББАС	мр
АЛИАГА	мр
АЛИАДА	мр
АЛИАДИН	мр
АЛИАКБАР	мр
АЛИАКБЕР	мр
АЛИАКПЕР	мр
АЛИАКРАМ	мр
АЛИАН	мр
АЛИАНА	жр
АЛИАР	мр
АЛИАСКЕР	мр
АЛИАСХАБ	мр
АЛИАТА	жр
АЛИАХМАД	мр
АЛИАХМЕД	мр
АЛИАШ	мр
АЛИБ	мр
АЛИБАБА	мр
АЛИБАЙ	мр
АЛИБАЙРАМ	мр
АЛИБАЛА	мр
АЛИБЕГ	мр
АЛИБЕЙ	мр
АЛИБЕК	мр
АЛИБУЛАТ	мр
АЛИВ	мр
АЛИВЕРДИ	мр
АЛИВИАН	мр
АЛИВИЯ	жр
АЛИВТИН	мр
АЛИВТИНА	жр
АЛИГАДЖИ	мр
АЛИГАН	мр
АЛИГАСАН	мр
АЛИГЕЙДАР	мр
АЛИГУЗУ	мр
АЛИГУЛУ	мр
АЛИГУСЕЙН	мр
АЛИД	мр
АЛИДА	жр
АЛИДАН	мр
АЛИДАР	мр
АЛИДЕ	мр
АЛИДЕР	мр
АЛИДЖАН	мр
АЛИДЖОН	мр
АЛИДИН	мр
АЛИДИЯ	жр
АЛИДЭ	жр
АЛИЖАН	мр
АЛИЖОН	мр
АЛИЗ	мр
АЛИЗА	жр
АЛИЗАДА	жр
АЛИЗАДЕ	мр
АЛИЗАМАН	мр
АЛИЗАМИН	мр
АЛИЗАР	мр
АЛИЗЕ	жр
АЛИЗОР	мр
АЛИИ	мр
АЛИЙ	мр
АЛИК	мр
АЛИКА	жр
АЛИКАН	мр
АЛИКАНИДА	жр
АЛИКАРА	жр
АЛИКБЕР	мр
АЛИКЕР	мр
АЛИКЕРИМ	мр
АЛИКО	мр
АЛИКПЕР	мр
АЛИКРАМ	мр
АЛИКС	мр
АЛИКСАН	мр
АЛИКСЕЙ	мр
АЛИКТИНА	жр
АЛИКУЛ	мр
АЛИКУЛУ	мр
АЛИКУШАД	мр
АЛИКШЕР	мр
АЛИЛ	мр
АЛИЛИ	мр
АЛИМ	мр
АЛИМ-АБДУЛ	мр
АЛИМА	жр
АЛИМАГАМЕД	мр
АЛИМАГОМЕД	мр
АЛИМАДЖАН	мр
АЛИМАМЕД	мр
АЛИМАН	мр
АЛИМАРДАН	мр
АЛИМАТ	мр
АЛИМАХМАД	мр
АЛИМБАЙ	мр
АЛИМБЕК	мр
АЛИМГЕРЕЙ	мр
АЛИМДЖАН	мр
АЛИМДЖОН	мр
АЛИМЕ	мр
АЛИМЕР	мр
АЛИМЕРДЕН	мр
АЛИМЕРЗА	мр
АЛИМЕТ	мр
АЛИМЖА	мр
АЛИМЖАН	мр
АЛИМЖОН	мр
АЛИМЗЯН	мр
АЛИМИР	мр
АЛИМИРЗА	мр
АЛИММА	жр
АЛИМПАША	мр
АЛИМПИА	жр
АЛИМПИАДА	жр
АЛИМПИЙ	мр
АЛИМПИНА	жр
АЛИМПИЯ	жр
АЛИМСОЛТАН	мр
АЛИМСУЛТАН	мр
АЛИМУРАД	мр
АЛИМУРАТ	мр
АЛИМУС	мр
АЛИМУХТАР	мр
АЛИМХАЖИ	мр
АЛИМХАН	мр
АЛИМХОН	мр
АЛИМЯ	жр
АЛИН	мр
АЛИНА	жр
АЛИНАЗАР	мр
АЛИНАР	мр
АЛИНАТ	мр
АЛИНДА	жр
АЛИНИЯ	жр
АЛИНИЯЗ	мр
АЛИННА	жр
АЛИНТИН	мр
АЛИНТИНА	жр
АЛИНЭ	жр
АЛИОНА	жр
АЛИОНОРА	жр
АЛИОТ	мр
АЛИП	мр
АЛИПА	жр
АЛИПАША	мр
АЛИПИЙ	мр
АЛИРА	жр
АЛИРЕЗА	жр
АЛИРЗА	мр
АЛИРИЗА	жр
АЛИСА	жр
АЛИСАГ	мр
АЛИСАЛАМ	мр
АЛИСАФА	жр
АЛИСАХИБ	мр
АЛИСЕ	мр
АЛИСЕЙРАН	мр
АЛИСИЙ	мр
АЛИСИЯ	жр
АЛИСКЕНДАР	мр
АЛИСКЕР	мр
АЛИСЛАВ	мр
АЛИСЛАМ	мр
АЛИСО	мр
АЛИСОН	мр
АЛИССА	жр
АЛИСТА	жр
АЛИСТАРФ	мр
АЛИСТЕР	мр
АЛИСТИНА	жр
АЛИСТРАТ	мр
АЛИСТРАХО	мр
АЛИСУЛТАН	мр
АЛИСХАН	мр
АЛИТ	мр
АЛИТА	жр
АЛИТДИН	мр
АЛИТЕР	мр
АЛИТЕТ	мр
АЛИТЖАН	мр
АЛИТИЯ	жр
АЛИТТА	жр
АЛИУ	мр
АЛИУЛА	жр
АЛИФ	мр
АЛИФА	жр
АЛИФАГА	мр
АЛИФАТ	мр
АЛИФЕ	жр
АЛИФЕНДИ	мр
АЛИФЕР	мр
АЛИФЕРИЙ	мр
АЛИФИЯ	жр
АЛИФТИН	мр
АЛИФТИНА	жр
АЛИФХАН	мр
АЛИФЯ	жр
АЛИХ	мр
АЛИХАМ	мр
АЛИХАН	мр
АЛИХАСАН	мр
АЛИХМАН	мр
АЛИХМЕД	мр
АЛИХОН	мр
АЛИЦА	жр
АЛИЦЕ	жр
АЛИЦИЯ	жр
АЛИЧ	мр
АЛИЧУБАН	мр
АЛИШ	мр
АЛИША	жр
АЛИШАН	мр
АЛИШЕ	жр
АЛИШЕВ	мр
АЛИШЕР	мр
АЛИШИР	мр
АЛИЩЕР	мр
АЛИЮ	жр
АЛИЮЛА	жр
АЛИЮСИФ	мр
АЛИЯ	жр
АЛИЯДДИН	мр
АЛИЯКБЯР	мр
АЛИЯМ	мр
АЛИЯНА	жр
АЛИЯР	мр
АЛКАЗАР	мр
АЛКАН	мр
АЛКЕН	мр
АЛКЕТ	мр
АЛКИВИАД	мр
АЛКИНОЯ	жр
АЛКИС	мр
АЛКСАНДРА	жр
АЛКСНИС	мр
АЛКУН	мр
АЛЛ	мр
АЛЛА	жр
АЛЛАБЕРГЕН	мр
АЛЛАБЕРДИ	жр
АЛЛАДИН	мр
АЛЛАДУРДЫ	мр
АЛЛАЗ	мр
АЛЛАИДА	жр
АЛЛАК	мр
АЛЛАКУЛЫ	мр
АЛЛАЛ	мр
АЛЛАМУРАД	мр
АЛЛАМУРАТ	мр
АЛЛАН	мр
АЛЛАНАЗАР	мр
АЛЛАР	мр
АЛЛАХВЕРДИ	мр
АЛЛАХВЕРДЫ	мр
АЛЛАХЯР	мр
АЛЛАЯР	мр
АЛЛЕВТИНА	жр
АЛЛЕН	мр
АЛЛЕНТИНА	жр
АЛЛЕФТИНА	жр
АЛЛИ	мр
АЛЛИЙ	мр
АЛЛИК	мр
АЛЛИМ	мр
АЛЛИНА	жр
АЛЛИСА	жр
АЛЛИЯ	жр
АЛЛОИЗА	жр
АЛЛЯМ	мр
АЛЛЯМЕТДИН	мр
АЛЛЯМША	жр
АЛМА	жр
АЛМАБИКА	жр
АЛМАГУЛЬ	жр
АЛМАЖАН	мр
АЛМАЗИЯ	жр
АЛМАМБЕТ	мр
АЛМАН	мр
АЛМАРА	жр
АЛМАС	мр
АЛМАСБЕК	мр
АЛМАСТ	мр
АЛМАСХАН	мр
АЛМАТ	мр
АЛМЕ	мр
АЛМИРА	жр
АЛМИРЗА	мр
АЛНА	жр
АЛНИС	мр
АЛО	мр
АЛОВАТ	мр
АЛОВСАТ	мр
АЛОЕКСАНДР	мр
АЛОИДА	жр
АЛОИЗ	мр
АЛОИЗА	жр
АЛОИЗАС	мр
АЛОИЗИЙ	мр
АЛОИЗИЯ	жр
АЛОИС	мр
АЛОЙЗ	мр
АЛОЙС	мр
АЛОК	мр
АЛОМ	мр
АЛОМАТ	мр
АЛОН	мр
АЛОНА	жр
АЛОРИНА	жр
АЛОРИЯ	жр
АЛОСАТ	мр
АЛОУ	мр
АЛОЧКА	жр
АЛПАРСЛАН	мр
АЛПАСЛАН	мр
АЛПАША	мр
АЛПДИМИР	мр
АЛПЕР	мр
АЛПИИНА	жр
АЛПИНА	жр
АЛПЫСПАЙ	мр
АЛСАФА	жр
АЛСУ	жр
АЛТА	жр
АЛТАНА	жр
АЛТАР	мр
АЛТИ	мр
АЛТНАЙ	мр
АЛТУН	мр
АЛТЫ	мр
АЛТЫБАЙ	мр
АЛТЫНА	жр
АЛТЫНАЙ	жр
АЛТЫНБЕК	мр
АЛТЫНГУЛЬ	жр
АЛТЫНКУЛЬ	жр
АЛУ	мр
АЛУА	мр
АЛУДА	жр
АЛУИЗА	жр
АЛУКСАНДР	мр
АЛУРА	жр
АЛФ	мр
АЛФА	жр
АЛФАТ	мр
АЛФЕЙ	мр
АЛФЕС	мр
АЛФЕЯ	жр
АЛФИДА	жр
АЛФИЗА	жр
АЛФИЙ	мр
АЛФИМ	мр
АЛФИНА	жр
АЛФИНУР	мр
АЛФИР	мр
АЛФИРА	жр
АЛФИСА	жр
АЛФИЯ	жр
АЛФОНС	мр
АЛФОНСАС	мр
АЛФОНСУС	мр
АЛФРЕД	мр
АЛФРИДА	жр
АЛФРИТ	мр
АЛХАДДИН	мр
АЛХАЗУР	мр
АЛХАМ	мр
АЛХАН	мр
АЛХАС	мр
АЛХАТ	мр
АЛШИР	мр
АЛЫ	мр
АЛЫГДЖЕР	мр
АЛЫМ	мр
АЛЫМБЕК	мр
АЛЫШАН	мр
АЛЬБАРТ	мр
АЛЬБАЦ	мр
АЛЬБЕК	мр
АЛЬБЕНА	жр
АЛЬБЕР	мр
АЛЬБЕРА	жр
АЛЬБЕРД	мр
АЛЬБЕРИНА	жр
АЛЬБЕРТ	мр
АЛЬБЕРТАС	мр
АЛЬБЕРТИН	мр
АЛЬБЕРТИНА	жр
АЛЬБЕРТО	мр
АЛЬБЕРТС	мр
АЛЬБЕТР	мр
АЛЬБИДА	жр
АЛЬБИЙ	мр
АЛЬБИН	мр
АЛЬБИНА	жр
АЛЬБИНАС	мр
АЛЬБИНУР	мр
АЛЬБИНУС	мр
АЛЬБИРА	жр
АЛЬБИРИНА	жр
АЛЬБИРТ	мр
АЛЬБИТА	жр
АЛЬБИЯ	жр
АЛЬБО	мр
АЛЬБОНА	жр
АЛЬБРЕХТ	мр
АЛЬБЯРТАС	мр
АЛЬВА	жр
АЛЬВАРА	жр
АЛЬВАРД	мр
АЛЬВАРЕС	мр
АЛЬВАРТ	мр
АЛЬВЕНТИНА	жр
АЛЬВЕР	мр
АЛЬВЕРА	жр
АЛЬВЕРТ	мр
АЛЬВЕТА	жр
АЛЬВИ	жр
АЛЬВИАН	мр
АЛЬВИАНА	жр
АЛЬВИДА	жр
АЛЬВИДАС	мр
АЛЬВИН	мр
АЛЬВИНА	жр
АЛЬВИОН	мр
АЛЬВИР	мр
АЛЬВИРА	жр
АЛЬВИРТ	мр
АЛЬВИТА	жр
АЛЬВИЯ	жр
АЛЬВИЯН	мр
АЛЬГА	жр
АЛЬГЕРД	мр
АЛЬГЕРДАС	мр
АЛЬГЕРТ	мр
АЛЬГИДАС	мр
АЛЬГИДРАС	мр
АЛЬГИМАНТА	жр
АЛЬГИМАНТАС	мр
АЛЬГИМОНТАС	мр
АЛЬГИНА	жр
АЛЬГИНАТ	мр
АЛЬГИРДАС	мр
АЛЬГИС	мр
АЛЬДА	жр
АЛЬДЕР	мр
АЛЬДИН	мр
АЛЬДИЯ	жр
АЛЬДО	мр
АЛЬДОН	мр
АЛЬДОНА	жр
АЛЬЕ	мр
АЛЬЖАНАТ	жр
АЛЬЖБЕТА	жр
АЛЬЗАМ	мр
АЛЬЗИРА	жр
АЛЬИНА	жр
АЛЬКА	мр
АЛЬКЕН	мр
АЛЬМАЗ	мр
АЛЬМАР	мр
АЛЬМАРА	жр
АЛЬМЕ	мр
АЛЬМЕР	мр
АЛЬМИДА	жр
АЛЬМИНА	жр
АЛЬМИНУР	мр
АЛЬМИР	мр
АЛЬМИРА	жр
АЛЬМУХАМЕТ	мр
АЛЬНА	жр
АЛЬНУР	мр
АЛЬНУРА	жр
АЛЬОНА	жр
АЛЬОРИЯ	жр
АЛЬП	мр
АЛЬПЕР	мр
АЛЬПИДА	жр
АЛЬПИНА	жр
АЛЬСИНА	жр
АЛЬСИЯ	жр
АЛЬТАНА	жр
АЛЬТАФ	мр
АЛЬТЕР	мр
АЛЬТИНА	жр
АЛЬТУС	мр
АЛЬТЮС	мр
АЛЬФ	мр
АЛЬФАД	мр
АЛЬФАН	мр
АЛЬФАНИС	мр
АЛЬФАРИД	мр
АЛЬФАТ	мр
АЛЬФЕД	мр
АЛЬФЕЙ	мр
АЛЬФЕР	мр
АЛЬФЕРА	жр
АЛЬФЕРТ	мр
АЛЬФЕТ	мр
АЛЬФЕЯ	жр
АЛЬФИА	жр
АЛЬФИДА	жр
АЛЬФИЗА	жр
АЛЬФИЙ	мр
АЛЬФИК	мр
АЛЬФИН	мр
АЛЬФИНА	жр
АЛЬФИНОР	мр
АЛЬФИНОРА	жр
АЛЬФИНУР	мр
АЛЬФИНУРА	жр
АЛЬФИО	мр
АЛЬФИР	мр
АЛЬФИРА	жр
АЛЬФИС	мр
АЛЬФИСА	жр
АЛЬФИТ	мр
АЛЬФИТИНА	жр
АЛЬФИЯ	жр
АЛЬФОН	мр
АЛЬФОНАС	мр
АЛЬФОНОС	мр
АЛЬФОНС	мр
АЛЬФОНСА	жр
АЛЬФОНСАС	мр
АЛЬФОНСИНА	жр
АЛЬФОНСО	мр
АЛЬФОНСОС	мр
АЛЬФОНСУС	мр
АЛЬФРЕД	мр
АЛЬФРЕДА	жр
АЛЬФРЕДАС	мр
АЛЬФРЕДИЯ	жр
АЛЬФРЕДО	мр
АЛЬФРЕТ	мр
АЛЬФРИД	мр
АЛЬФРИДА	жр
АЛЬФРИТ	мр
АЛЬХАДЖ	мр
АЛЬХАЛАБИ	мр
АЛЬХАТ	мр
АЛЬХИЯ	жр
АЛЬЦИОНА	жр
АЛЬЧИС	мр
АЛЬШЕР	мр
АЛЬШМАНТАС	мр
АЛЬЯ	жр
АЛЬЯНА	жр
АЛЬЯР	мр
АЛЬЯС	мр
АЛЭН	мр
АЛЮБИНА	жр
АЛЮС	мр
АЛЮСИЯ	жр
АЛЮСЯ	жр
АЛЮТА	жр
АЛЮТИНА	жр
АЛЯ	жр
АЛЯДДИН	мр
АЛЯДИН	мр
АЛЯЗ	мр
АЛЯКСАС	мр
АЛЯМДИН	мр
АЛЯМША	жр
АЛЯН	мр
АЛЯНА	жр
АЛЯР	мр
АЛЯРА	жр
АЛЯТ	мр
АМАД	мр
АМАДА	жр
АМАДЕО	мр
АМАЗАС	мр
АМАЗАСП	мр
АМАИДА	жр
АМАИЛ	мр
АМАЙ	мр
АМАЛИА	жр
АМАЛИК	мр
АМАЛИЯ	жр
АМАЛЬ	мр
АМАЛЯ	жр
АМАН	мр
АМАНБАЙ	мр
АМАНБЕК	мр
АМАНГАЛДЫ	мр
АМАНГЕЛДИ	мр
АМАНГЕЛЬДИ	мр
АМАНГЕЛЬДЫ	мр
АМАНГУЛЬ	жр
АМАНДА	жр
АМАНДЖОН	мр
АМАНДИЙ	мр
АМАНДИП	мр
АМАНДУРДЫ	мр
АМАНДЫК	мр
АМАНЖОЛ	мр
АМАНИЛДИ	мр
АМАНИЯ	жр
АМАНКЕЛДЫ	мр
АМАНКОС	мр
АМАНКУЛ	мр
АМАНКУЛЬ	жр
АМАНМУРАД	мр
АМАНМУРАТ	мр
АМАНТАЙ	мр
АМАНУИЛ	мр
АМАНУЛА	жр
АМАНУЛЛА	мр
АМАНУЛЛО	мр
АМАНУЛО	мр
АМАНЯЗ	мр
АМАР	мр
АМАРА	жр
АМАРБИЙ	мр
АМАРДЖИТ	мр
АМАРДИП	мр
АМАРДИТ	мр
АМАРЕШ	мр
АМАСИЙ	мр
АМАСПЮР	мр
АМАСЯ	жр
АМАТУЛЛА	мр
АМАЯК	мр
АМАЯН	мр
АМБ	мр
АМБАРУМ	мр
АМБАРЦУМ	мр
АМБРОС	мр
АМБРОСИЙ	мр
АМВЕР	мр
АМВИР	мр
АМВРОСИЙ	мр
АМГАЛАН	мр
АМДЖАД	мр
АМДЖЕД	мр
АМЕД	мр
АМЕДЖАН	мр
АМЕЛА	жр
АМЕЛЬ	жр
АМЕЛЯ	жр
АМЕНА	жр
АМЕНАТ	мр
АМЕНИЯ	жр
АМЕНЯ	жр
АМЕР	мр
АМЕРАН	мр
АМЕРУЛЛА	мр
АМЕРХАН	мр
АМЕСТ	мр
АМЕТ	мр
АМЕТ-ХАН	мр
АМЕТХАН	мр
АМЖАД	мр
АМЗА	жр
АМИ	мр
АМИДА	жр
АМИДЕ	мр
АМИК	мр
АМИКО	мр
АМИЛА	жр
АМИЛИЯ	жр
АМИЛЬ	мр-жр
АМИЛЬДА	жр
АМИЛЯ	жр
АМИМ	мр
АМИН	мр
АМИНАД	мр
АМИНАТ	мр
АМИНБАЙ	мр
АМИНЕ	жр
АМИНЕТ	мр
АМИНИ	мр
АМИНИЯ	жр
АМИНУЛ	мр
АМИНЯ	мр
АМИНЯ-ХАН	мр
АМИР	мр
АМИР-АЛИ	мр
АМИРА	жр
АМИРАГА	мр
АМИРАК	мр
АМИРАЛИ	мр
АМИРАМ	мр
АМИРАН	мр
АМИРАНА	жр
АМИРАНИ	жр
АМИРАСЛАН	мр
АМИРАТ	мр
АМИРАХ	мр
АМИРАХМЕД	мр
АМИРБЕК	мр
АМИРГАМЗА	мр
АМИРДЖАН	мр
АМИРДЖОН	мр
АМИРЖАН	мр
АМИРЗА	мр
АМИРЗАН	мр
АМИРИДОН	мр
АМИРИН	мр
АМИРКАН	мр
АМИРОН	мр
АМИРОСЛАН	мр
АМИРСУЛТАН	мр
АМИРУЛЛА	мр
АМИРУШ	мр
АМИРХАН	мр
АМИРХОН	мр
АМИРХОССЕЙН	мр
АМИРША	жр
АМИРШАХ	мр
АМИРШО	мр
АМИРЬЯН	мр
АМИРЯН	мр
АМИТ	мр
АМИТАБХ	мр
АМИТАВА	жр
АМИТЬ	жр
АМЛЕТ	мр
АММА	жр
АММАР	мр
АММИ	мр
АМНА	жр
АМНАТ	мр
АМНЕРИС	жр
АМНИЙ	мр
АМНОН	мр
АМО	мр
АМОЛЯ	жр
АМОН	мр
АМОНУЛЛО	мр
АМОР	мр
АМОС	мр
АМОЯК	мр
АМПЛЕЙ	мр
АМПЛИЙ	мр
АМРА	жр
АМРАГ	мр
АМРАЛИ	мр
АМРАМ	мр
АМРАН	мр
АМРАСЛАН	мр
АМРАСТАН	мр
АМРАХ	мр
АМРЕ	мр
АМРЕНДРА	жр
АМРИ	мр
АМРИДДИН	мр
АМРИДИН	мр
АМРИК	мр
АМРИЯ	жр
АМРО	мр
АМРОСИЙ	мр
АМРУЛА	жр
АМРУЛЛА	мр
АМРУЛЛАХ	мр
АМРУЛЛО	мр
АМУ	мр
АМУРБЕК	мр
АМУРБИ	мр
АМУРБИЙ	мр
АМУРЛА	жр
АМУРХАН	мр
АМУШ	мр
АМФИЯ	жр
АМЫРХАН	мр
АНАБИБИ	мр
АНАВ	мр
АНАГИД	мр
АНАГИТ	мр
АНАД	мр
АНАИД	мр
АНАИДА	жр
АНАИС	жр
АНАИТА	жр
АНАЙДА	жр
АНАЙТ	мр
АНАКИЙ	мр
АНАКРЕОН	мр
АНАЛИЙ	мр
АНАЛИНА	жр
АНАЛИЯ	жр
АНАЛОЛИЙ	мр
АНАЛЯ	жр
АНАН	мр
АНАНД	мр
АНАНИ	мр
АНАНИЙ	мр
АНАНИК	мр
АНАНИН	мр
АНАНИЯ	жр
АНАНТ	мр
АНАНТА	жр
АНАОТЛИЙ	мр
АНАПСТАСИЯ	жр
АНАР	мр
АНАРА	жр
АНАРБАЙ	мр
АНАРБЕК	мр
АНАРЕЙ	мр
АНАРИЙ	мр
АНАРИК	мр
АНАС	мр
АНАСИЯ	жр
АНАСС	мр
АНАСТА	жр
АНАСТАЗИЙ	мр
АНАСТАЗИЯ	жр
АНАСТАИСЯ	жр
АНАСТАЛИЯ	жр
АНАСТАМИЯ	жр
АНАСТАНИЯ	жр
АНАСТАНСИЯ	жр
АНАСТАС	мр
АНАСТАСИИЯ	жр
АНАСТАСИЙ	мр
АНАСТАСИЯ	жр
АНАСТАСЬЯ	жр
АНАСТАЦИЯ	жр
АНАСТИЯ	жр
АНАСТОСИЯ	жр
АНАСЬЯ	жр
АНАТ	мр
АНАТАЛИЙ	мр
АНАТАЛИЯ	жр
АНАТАЛЬЯ	жр
АНАТАСИЯ	жр
АНАТИЛИЙ	мр
АНАТЛИЙ	мр
АНАТЛЬЯ	жр
АНАТОДИЙ	мр
АНАТОДЛИЙ	мр
АНАТОЙ	мр
АНАТОЛИЙ	мр
АНАТОЛИН	мр
АНАТОЛИНА	жр
АНАТОЛИС	мр
АНАТОЛИЯ	жр
АНАТОЛЬ	мр
АНАТОН	мр
АНАТОНИЙ	мр
АНАТОНИНА	жр
АНАТРЛИЙ	мр
АНАТСАСИЯ	жр
АНАФИЙ	мр
АНАФИС	мр
АНАФИЯ	жр
АНАХАНУМ	мр
АНБАР	мр
АНБЕР	мр
АНВАР	мр
АНВАРА	жр
АНВАРБЕК	мр
АНВАРБИК	мр
АНВАРДЖАН	мр
АНВАРЖАН	мр
АНВАРЖОН	мр
АНВАРИЯ	жр
АНВАРПАША	мр
АНВАРША	жр
АНВАРЬ	жр
АНВЕЛ	мр
АНВЕР	мр
АНВЕРБЕК	мр
АНВЕРБИК	мр
АНВИР	мр
АНВТОЛИЙ	мр
АНВЭР	мр
АНВЭРЬ	жр
АНВЯР	мр
АНВЯРЬ	жр
АНГА	жр
АНГАЛИНА	жр
АНГАМ	мр
АНГЕЛА	жр
АНГЕЛИЙ	мр
АНГЕЛИНА	жр
АНГЕЛИЯ	жр
АНГЕЛЬНА	жр
АНГЕЛЬСИНА	жр
АНГЕЛЯ	жр
АНГИЛ	мр
АНГИЛИНА	жр
АНГИСА	жр
АНГИЯ	жр
АНГЛИНА	жр
АНГЛИСА	жр
АНГОН	мр
АНДА	жр
АНДАР	мр
АНДЕЖДА	жр
АНДЕЙ	мр
АНДЕН	мр
АНДЕРС	мр
АНДЖЕЙ	мр
АНДЖЕЛА	жр
АНДЖЕЛИКА	жр
АНДЖЕЛИНА	жр
АНДЖЕЛИТА	жр
АНДЖЕЛИЯ	жр
АНДЖЕЛЛА	жр
АНДЖЕЛО	мр
АНДЖИЙ	мр
АНДЖРЕЙ	мр
АНДЗОР	мр
АНДИ	мр
АНДИАН	мр
АНДИЙ	мр
АНДИН	мр
АНДИЯ	жр
АНДО	мр
АНДОН	мр
АНДОР	мр
АНДОРЕЙ	мр
АНДОРИ	мр
АНДПЕЙ	мр
АНДРА	жр
АНДРАДЕ	жр
АНДРАНЕК	мр
АНДРАНИК	мр
АНДРАНИН	мр
АНДРАННИК	мр
АНДРАС	мр
АНДРАШ	мр
АНДРЕ	мр
АНДРЕА	жр
АНДРЕАН	мр
АНДРЕАНА	жр
АНДРЕАС	мр
АНДРЕВ	мр
АНДРЕИ	мр
АНДРЕЙ	мр
АНДРЕЙС	мр
АНДРЕЙЦ	мр
АНДРЕНИК	мр
АНДРЕС	мр
АНДРЕЮС	мр
АНДРЕЯН	мр
АНДРИ	мр
АНДРИА	жр
АНДРИАН	мр
АНДРИАНА	жр
АНДРИАНИК	мр
АНДРИАННА	жр
АНДРИАНО	мр
АНДРИАС	мр
АНДРИЕН	мр
АНДРИЕШ	мр
АНДРИЙ	мр
АНДРИК	мр
АНДРИНЕ	жр
АНДРИОН	мр
АНДРИС	мр
АНДРИЯ	жр
АНДРИЯН	мр
АНДРИЯНА	жр
АНДРО	мр
АНДРОМЕДА	жр
АНДРОН	мр
АНДРОНИЙ	мр
АНДРОНИК	мр
АНДРОНИКА	жр
АНДРОШ	мр
АНДРУС	мр
АНДРУШ	мр
АНДРЮС	мр
АНДРЮША	мр
АНДТЕЙ	мр
АНЕЗА	жр
АНЕЗИЯ	жр
АНЕЙ	мр
АНЕКТ	мр
АНЕЛ	мр
АНЕЛА	жр
АНЕЛИНА	жр
АНЕЛИЯ	жр
АНЕЛЛА	жр
АНЕЛЛИНА	жр
АНЕЛЛИЯ	жр
АНЕЛЛЯ	жр
АНЕЛЬ	жр
АНЕЛЬКА	жр
АНЕЛЬЯ	жр
АНЕЛЯ	жр
АНЕМАИСА	жр
АНЕМПОДИСТ	мр
АНЕНА	жр
АНЕР	мр
АНЕС	жр
АНЕСА	жр
АНЕССА	жр
АНЕСТИС	мр
АНЕТА	жр
АНЕТТА	жр
АНЕЧКА	жр
АНЖАЛА	жр
АНЖАНА	жр
АНЖЕЙ	мр
АНЖЕЛ	мр
АНЖЕЛА	жр
АНЖЕЛИКА	жр
АНЖЕЛИН	мр
АНЖЕЛИНА	жр
АНЖЕЛИТА	жр
АНЖЕЛИЯ	жр
АНЖЕЛЛА	жр
АНЖЕЛЛИКА	жр
АНЖЕЛО	мр
АНЖЕЛЬ	жр
АНЖЕЛЯ	жр
АНЖИ	мр
АНЖИК	мр
АНЖИЛИКА	жр
АНЖИЛИНА	жр
АНЖРЕЙ	мр
АНЖЭЛА	жр
АНЖЭЛИКА	жр
АНЗАР	мр
АНЗАУР	мр
АНЗЕЛЬМ	мр
АНЗЕЛЬМА	жр
АНЗЕЛЬМАС	мр
АНЗИМА	жр
АНЗИРА	жр
АНЗИРАТ	мр
АНЗИЯ	жр
АНЗОВ	мр
АНЗОР	мр
АНЗОРИ	мр
АНЗОРИЙ	мр
АНЗУР	мр
АНЗУРАТ	мр
АНИ	мр
АНИА	жр
АНИВАС	мр
АНИДА	жр
АНИЗА	жр
АНИЗЕ	жр
АНИЙ	мр
АНИК	мр
АНИКА	жр
АНИКЕЙ	мр
АНИКИЙ	мр
АНИКО	жр
АНИЛ	мр
АНИЛА	жр
АНИЛИНА	жр
АНИЛИЯ	жр
АНИЛЬ	мр
АНИЛЬЯ	жр
АНИЛЯ	жр
АНИМАИСА	жр
АНИМАН	мр
АНИМАНИСА	жр
АНИН	мр
АНИНА	жр
АНИНЕЛЯ	жр
АНИНЬЯ	жр
АНИОНИНА	жр
АНИП	мр
АНИРА	жр
АНИРУДХ	мр
АНИС	мр
АНИСА	жр
АНИСАТ	мр
АНИСЕЛА	жр
АНИСИЙ	мр
АНИСИМ	мр
АНИСИМА	жр
АНИСИЯ	жр
АНИСКА	жр
АНИСЛАВ	мр
АНИСУЗЗАМАН	мр
АНИСУР	мр
АНИСЬЯ	жр
АНИСЭ	жр
АНИСЯ	жр
АНИТ	мр
АНИТА	жр
АНИФ	мр
АНИФА	жр
АНИФЕ	жр
АНИЦА	жр
АНИЦЕТА	жр
АНИЦЕТАС	мр
АНИЧКА	жр
АНИШ	мр
АНИШОАРА	жр
АНИЯТ	мр
АНКА	жр
АНКИН	мр
АНКИТ	мр
АНКО	мр
АНКУР	мр
АНМАН	мр
АНМАР	мр
АННА	жр
АННАБЕЛЛА	жр
АННАБЕРДЫ	мр
АННАГЕЛЬДЫ	мр
АННАГИ	мр
АННАГУЛЬ	жр
АННАЗАР	мр
АННАИД	жр
АННАИДА	жр
АННАИТ	мр
АННАМАРИЯ	жр
АННАМУРАД	мр
АННАМУХАММЕТ	мр
АННАМЫРАТ	мр
АННАНИЙ	мр
АННАРИЙ	мр
АННАСАХАТ	мр
АННЕ	жр
АННЕЛИНА	жр
АННЕЛИЯ	жр
АННЕЛЬ	жр
АННЕЛЯ	жр
АННЕМАРИ	жр
АННЕСА	жр
АННЕТА	жр
АННЕТТА	жр
АННИ	мр
АННИК	мр
АННИКА	жр
АННИНА	жр
АННИСА	жр
АННИТА	жр
АННМАН	мр
АННО	мр
АННУШ	мр
АННЭ	жр
АННЭТА	жр
АНО	мр
АНОВАР	мр
АНОИД	мр
АНОИДА	жр
АНОИТ	мр
АНОЛИЙ	мр
АНОЛИНАРИЯ	жр
АНОН	мр
АНОНИЛА	жр
АНОНИНА	жр
АНОННА	жр
АНОР	мр
АНОРА	жр
АНОРБАЙ	мр
АНОРИСА	жр
АНОРИЯ	жр
АНОРХАЛ	мр
АНОРХОН	мр
АНОСТАСИЯ	жр
АНОТОЛИЙ	мр
АНРАНИК	мр
АНРЕЙ	мр
АНРИ	мр-жр
АНРИК	мр
АНРИС	мр
АНС	мр
АНСАР	мр
АНСАРИ	жр
АНСАФ	мр
АНСЕР	мр
АНСЛЕМ	мр
АНСУР	мр
АНТАЛ	мр
АНТАЛИЯ	жр
АНТАН	мр
АНТАНАС	мр
АНТАНИДА	жр
АНТАНИНА	жр
АНТАНОС	мр
АНТАР	мр
АНТАРАМ	мр
АНТЕЛА	жр
АНТЕЛИКА	жр
АНТЕЛИНА	жр
АНТЕПА	жр
АНТЕЯ	жр
АНТИ	мр
АНТИГА	жр
АНТИГОНА	жр
АНТИЙ	мр
АНТИКО	мр
АНТИМОЗ	мр
АНТИН	мр
АНТИНА	жр
АНТИНИНА	жр
АНТИНОГЕН	мр
АНТИП	мр
АНТИПИЙ	мр
АНТИСА	жр
АНТНОНИНА	жр
АНТОАНЕТА	жр
АНТОЕ	мр
АНТОЛ	мр
АНТОЛИЙ	мр
АНТОЛИНА	жр
АНТОМИДА	жр
АНТОН	мр
АНТОНАНДР	мр
АНТОНАС	мр
АНТОНГ	мр
АНТОНЕЛЛА	жр
АНТОНЕТА	жр
АНТОНЕТТА	жр
АНТОНИ	мр
АНТОНИА	жр
АНТОНИАН	мр
АНТОНИАНА	жр
АНТОНИГА	жр
АНТОНИД	мр
АНТОНИДА	жр
АНТОНИЙ	мр
АНТОНИКА	жр
АНТОНИН	мр
АНТОНИНА	жр
АНТОНИНДА	жр
АНТОНИО	мр
АНТОНИОС	мр
АНТОНИТА	жр
АНТОНИУС	мр
АНТОНИЯ	жр
АНТОННА	жр
АНТОНО	мр
АНТОНОНА	жр
АНТОНОС	мр
АНТОС	мр
АНТОСЬ	мр
АНТОСЯ	жр
АНТРА	жр
АНТРАНИК	мр
АНТРОП	мр
АНТС	мр
АНТУАН	мр
АНТУАНЕТА	жр
АНТУАНЕТТА	жр
АНТУАННЕТА	жр
АНТУН	мр
АНТУШ	мр
АНУАР	мр
АНУАРБЕК	мр
АНУДЖ	мр
АНУЗА	жр
АНУЗЯ	жр
АНУЛА	жр
АНУМ	мр
АНУП	мр
АНУПАМ	мр
АНУР	мр
АНУРА	жр
АНУРАГ	мр
АНУСЯ	жр
АНУТА	жр
АНУФРИЙ	мр
АНУШ	жр
АНУША	жр
АНУШАВАН	мр
АНУШВАН	мр
АНУШЕВАН	мр
АНУШИК	мр
АНУШОВАН	мр
АНФА	жр
АНФАР	мр
АНФЕЯ	жр
АНФИЗА	жр
АНФИЗИЯ	жр
АНФИЛ	мр
АНФИЛА	жр
АНФИЛОФИЙ	мр
АНФИМ	мр
АНФИН	мр
АНФИНА	жр
АНФИНОГЕН	мр
АНФИР	мр
АНФИРА	жр
АНФИС	мр
АНФИСА	жр
АНФИСИЯ	жр
АНФИСЯ	жр
АНФИЯ	жр
АНФУЛА	жр
АНФУСА	жр
АНФУСЬЯ	жр
АНХ	мр
АНХАР	жр
АНХЕЛ	мр
АНХЕЛА	жр
АНХЕЛИКА	жр
АНХЕЛИТА	жр
АНХИМ	мр
АНЧЕЛ	мр
АНША	жр
АНШЕ	жр
АНЫ	мр
АНЫМ	мр
АНЬВЯР	мр
АНЬЕ	жр
АНЬЕС	мр
АНЬЦИ	мр
АНЬЯ	жр
АНЭЛИНА	жр
АНЭЛИЯ	жр
АНЭЛЯ	жр
АНЭТА	жр
АНЮСА	жр
АНЮТА	жр
АНЯ	жр
АОД	мр
АОРЕТ	мр
АПАЛИНАРИЯ	жр
АПАЛОН	мр
АПАНАСИЯ	жр
АПАНДИ	мр
АПАС	мр
АПЕЛАГЕЯ	жр
АПЕЛИЯ	жр
АПЕТ	мр
АПЕТНАК	мр
АПИЛИНА	жр
АПИМ	мр
АПОЛЕНИЯ	жр
АПОЛИНА	жр
АПОЛИНАРИЙ	мр
АПОЛИНАРИЯ	жр
АПОЛИНАРЬЯ	жр
АПОЛЛИНАРИЙ	мр
АПОЛЛИНАРИЯ	жр
АПОЛЛОН	мр
АПОЛЛОНИЙ	мр
АПОЛЛОНИЯ	жр
АПОЛОН	мр
АПОЛОНИЙ	мр
АПОЛОНИЯ	жр
АПОЛОС	мр
АППАЗ	мр
АППАЛИНАРИЯ	жр
АППАС	мр
АППОЛИНА	жр
АППОЛИНАР	мр
АППОЛИНАРА	жр
АППОЛИНАРИЙ	мр
АППОЛИНАРИЯ	жр
АППОЛИНАРЬЯ	жр
АППОЛОН	мр
АППОЛОНИЙ	мр
АППОЛОНИЯ	жр
АПРЕЛИНА	жр
АПРЕС	мр
АПСИЛИЙ	мр
АПТИ	мр
АПФИЯ	жр
АРАБЕЛЛА	жр
АРАБХАН	мр
АРАВЕЛ	мр
АРАВИК	мр
АРАВИЛЬ	мр
АРАДИЙ	мр
АРАЗ	мр
АРАЗГУЛЬ	жр
АРАЗИ	мр
АРАЗИК	мр
АРАЗМУРАТ	мр
АРАЗХАН	мр
АРАИДА	жр
АРАИК	мр
АРАИКА	жр
АРАИН	мр
АРАЙ	мр
АРАЙИК	мр
АРАЙК	мр
АРАЙР	мр
АРАКЕЛ	мр
АРАКСА	жр
АРАКСИ	жр
АРАКСИЛ	мр
АРАКСИЯ	жр
АРАКСЯ	жр
АРАМ	мр
АРАМАИС	мр
АРАМАЙС	мр
АРАМАНС	мр
АРАМБИЙ	мр
АРАМИК	мр
АРАМИС	мр
АРАН	мр
АРАНКА	жр
АРАПАТ	мр
АРАРА	жр
АРАРАД	мр
АРАРАШ	мр
АРАС	мр
АРАСДУН	мр
АРАСТУН	мр
АРАСТУП	мр
АРАСУЛ	мр
АРАТОЛИЙ	мр
АРАТЮН	мр
АРАШ	мр
АРБАК	мр
АРБЕРТ	мр
АРБЕРТИНА	жр
АРБИ	мр
АРБИК	мр
АРБИНА	жр
АРБИЯТ	мр
АРБУХАН	мр
АРВЕД	мр
АРВЕЛОД	мр
АРВИ	мр
АРВИД	мр
АРВИДАС	мр
АРВИН	мр
АРВИНД	мр
АРВИС	мр
АРВИТ	мр
АРВО	мр
АРГАМ	мр
АРГЕН	мр
АРГЕНТ	мр
АРГЕНТА	жр
АРГИЛ	мр
АРГИНА	жр
АРГИНЕ	жр
АРГИРА	жр
АРГИШТИ	мр
АРГИШТЫ	мр
АРГУР	мр
АРД	мр
АРДАВАЗ	мр
АРДАВАЗД	мр
АРДАВАС	мр
АРДАВАСТ	мр
АРДАЛИОН	мр
АРДАЛЬОН	мр
АРДАМОН	мр
АРДАШ	мр
АРДАШЕС	мр
АРДЕВАН	мр
АРДЕМ	мр
АРДЖУН	мр
АРДИК	мр
АРДО	мр
АРДОЛЬОН	мр
АРЕАДНА	жр
АРЕВ	мр
АРЕВАК	мр
АРЕВАЛУЙС	мр
АРЕВАТ	мр
АРЕВГАТ	мр
АРЕВИК	мр
АРЕВХАТ	мр
АРЕВШАД	мр
АРЕВШАТ	мр
АРЕГ	мр
АРЕГА	жр
АРЕГНАЗ	мр
АРЕГНАЗАН	мр
АРЕЕН	мр
АРЕЙ	мр
АРЕК	мр
АРЕКНАЗ	мр
АРЕКНАЗАН	мр
АРЕЛ	мр
АРЕЛАН	мр
АРЕМ	мр
АРЕН	мр
АРЕНГОЛЬД	мр
АРЕСЛАН	мр
АРЕСТАК	мр
АРЕСТАКЕС	мр
АРЕСТИДИ	мр
АРЕТА	жр
АРЕФ	мр
АРЕФА	жр
АРЕФЕЙ	мр
АРЕФИ	мр
АРЕФИЙ	мр
АРЖАН	мр
АРЖЕНТИНА	жр
АРЗА	мр
АРЗАМЕТ	мр
АРЗЕН	мр
АРЗИ	мр
АРЗИК	мр
АРЗИКУЛ	мр
АРЗИН	мр
АРЗОН	мр
АРЗУ	мр
АРЗУЛЛА	мр
АРЗУМАН	мр
АРЗЫ	мр
АРИ	мр
АРИА	жр
АРИАДА	жр
АРИАДИЙ	мр
АРИАДНА	жр
АРИАН	мр
АРИАНА	жр
АРИАНДА	жр
АРИАНДНА	жр
АРИАННА	жр
АРИАС	мр
АРИБЖАН	мр
АРИБЖОН	мр
АРИГ	мр
АРИГА	жр
АРИЕ	жр
АРИЕЛ	мр
АРИЗ	мр
АРИЗА	жр
АРИЙ	мр
АРИК	мр
АРИКА	жр
АРИМ	мр
АРИМА	жр
АРИМАТ	мр
АРИН	мр
АРИНА	жр
АРИНАРХ	мр
АРИНЗЕ	жр
АРИО	мр
АРИОЛЬД	мр
АРИОН	мр
АРИП	мр
АРИПА	жр
АРИПЖАН	мр
АРИС	мр
АРИСА	жр
АРИСЛАН	мр
АРИСТ	мр
АРИСТА	жр
АРИСТАКЕС	мр
АРИСТАН	мр
АРИСТАРФ	мр
АРИСТАРХ	мр
АРИСТИД	мр
АРИСТИЦА	жр
АРИСТОКЕС	мр
АРИСТОТЕЛЬ	мр
АРИСХАН	мр
АРИТ	мр
АРИТА	жр
АРИФ	мр
АРИФА	жр
АРИФЕ	жр
АРИФЖАН	мр
АРИФУЛА	жр
АРИФУЛЛ	мр
АРИФУЛЛА	мр
АРИФЯ	жр
АРИЭЛЬ	мр
АРИЯДА	жр
АРИЯМ	мр
АРИЯНА	жр
АРКАД	мр
АРКАДИЙ	мр
АРКАДИК	мр
АРКАДИУШ	мр
АРКАДЯ	жр
АРКАЛИЙ	мр
АРКАМ	мр
АРКАША	мр
АРКЕЛ	мр
АРКЕН	мр
АРКИМЕД	мр
АРКИНАЗ	мр
АРКС	мр
АРЛАН	мр
АРЛЕН	мр
АРЛЕНА	жр
АРЛЕТА	жр
АРЛЕТТА	жр
АРЛИ	мр
АРЛИКИН	мр
АРЛИН	мр
АРЛИНА	жр
АРЛИНЕ	жр
АРМА	жр
АРМАГАН	мр
АРМАД	мр
АРМАИС	мр
АРМАК	мр
АРМАЛУИС	мр
АРМАЛУЙС	мр
АРМАН	мр-жр
АРМАНГУЛЬ	жр
АРМАНД	мр
АРМАНДА	жр
АРМАНДО	мр
АРМАНИС	мр
АРМАНС	мр
АРМАНУШ	мр
АРМАС	мр
АРМАШ	мр
АРМЕН	мр
АРМЕНА	жр
АРМЕНАК	мр
АРМЕНАХ	мр
АРМЕНЕ	жр
АРМЕНИ	мр
АРМЕНИК	мр
АРМЕНУА	жр
АРМЕНУИ	жр
АРМЕНУЙ	мр
АРМЕНУЛ	мр
АРМЕНУН	мр
АРМЕНУШ	мр
АРМЕНЦИ	мр
АРМИ	мр
АРМИДА	жр
АРМИК	мр
АРМИЛЬДА	жр
АРМИН	мр
АРМИНА	жр
АРМИНАК	мр
АРМИНС	мр
АРМИНУИ	мр
АРМИНЭ	мр
АРМИРА	жр
АРМО	мр
АРМОНД	мр
АРМОНИЯ	жр
АРМЭН	мр
АРНА	жр
АРНАБ	мр
АРНАД	мр
АРНАДИЙ	мр
АРНАК	мр
АРНГОЛЬД	мр
АРНГОЛЬТ	мр
АРНД	мр
АРНЕЛА	жр
АРНЕС	мр
АРНЕСТ	мр
АРНИ	мр
АРНИДА	жр
АРНИК	мр
АРНИС	мр
АРНОДИК	мр
АРНОЛД	мр
АРНОЛИЙ	мр
АРНОЛЬД	мр
АРНОЛЬДАС	мр
АРОЗ	мр
АРОЛЬД	мр
АРОМАИС	мр
АРОН	мр
АРОНИ	жр
АРОНКА	жр
АРОП	мр
АРОРА	жр
АРОСЛАН	мр
АРОТ	мр
АРПАД	мр
АРПЕНИК	мр
АРПЕНИКА	жр
АРПИ	жр
АРПИАР	мр
АРПИК	мр
АРПИНА	жр
АРПИНЕ	жр
АРПИТА	жр
АРРА	жр
АРСАЛАН	мр
АРСАН	мр
АРСАНАЛИ	мр
АРСАНОФИЙ	мр
АРСБИ	мр
АРСЕЙ	мр
АРСЕЛЬ	жр
АРСЕМ	мр
АРСЕН	мр
АРСЕНА	жр
АРСЕНИЙ	мр
АРСЕНТИЙ	мр
АРСЕНТИН	мр
АРСЕНЬ	жр
АРСИН	мр
АРСЛАМБЕК	мр
АРСЛАН	мр
АРСЛАН-АЛИ	мр
АРСЛАНАЛИ	мр
АРСЛАНБЕК	мр
АРСЛАНГАЛИ	мр
АРСЛОМ	мр
АРСЛОНБЕК	мр
АРСМА	мр
АРСОН	мр
АРСТАН	мр
АРСТАНБЕК	мр
АРСЫ	мр
АРСЭН	мр
АРТ	мр
АРТА	жр
АРТАВАЗ	мр
АРТАВАЗД	мр
АРТАВАС	мр
АРТАК	мр
АРТАЛУЙС	мр
АРТАМ	мр
АРТАМАС	мр
АРТАМЕС	мр
АРТАМОН	мр
АРТАН	мр
АРТАНИС	мр
АРТАШ	мр
АРТАША	жр
АРТАШЕК	мр
АРТАШЕС	мр
АРТЁМ	мр
АРТЕМА	жр
АРТЕМИДА	жр
АРТЕМИЙ	мр
АРТЕМИН	мр
АРТЕМИЯ	жр
АРТЕМОН	мр
АРТЕН	мр
АРТИ	мр
АРТИМ	мр
АРТИМИЗИЯ	жр
АРТИМОН	мр
АРТИН	мр
АРТО	мр
АРТОРИКС	мр
АРТОШ	мр
АРТОШЕС	мр
АРТУГ	мр
АРТУН	мр
АРТУР	мр
АРТУРАС	мр
АРТУРИЙ	мр
АРТУРИК	мр
АРТУРО	мр
АРТУРС	мр
АРТУШ	мр
АРТЫК	мр
АРТЫКБАЙ	мр
АРТЭК	мр
АРТЮМ	мр
АРТЮН	мр
АРТЮШ	мр
АРТЮША	мр
АРУ	мр
АРУВИК	мр
АРУЖАН	мр
АРУН	мр
АРУНА	жр
АРУНАС	мр
АРУНДАТИ	мр
АРУП	мр
АРУР	мр
АРУРУН	мр
АРУРУНИ	мр
АРУС	жр
АРУСАК	мр
АРУСИК	мр
АРУСТАМ	мр
АРУСЬЯК	мр
АРУСЯ	жр
АРУСЯК	мр
АРУСЯН	мр
АРУТ	мр
АРУТИК	мр
АРУТИН	мр
АРУТЮК	мр
АРУТЮН	мр
АРУТЯН	мр
АРУХАН	мр
АРФЕН	мр
АРФЕНИК	мр
АРФЕНИЯ	жр
АРФЕНЯ	жр
АРФИК	мр
АРХАН	мр
АРХЕЛАЯ	жр
АРХИЛАЯ	жр
АРХИМЕД	мр
АРХИН	мр
АРХИП	мр
АРХИР	мр
АРЦВИК	мр
АРЦЕВИК	мр
АРЦРУН	мр
АРЦРУНИ	мр
АРЦРУНИК	мр
АРЧАН	мр
АРЧИБАЛЬД	мр
АРЧИЛ	мр
АРЧИЛИ	мр
АРЧИЛЬ	мр
АРШАВЕЛ	мр
АРШАВИР	мр
АРШАД	мр
АРШАК	мр
АРШАЛУИС	мр
АРШАЛУЙ	мр
АРШАЛУЙЕ	мр
АРШАЛУЙС	мр
АРШАЛУС	мр
АРШАЛУСЬ	мр
АРШАЛУЮС	мр
АРШАЛЮС	мр
АРШАМ	мр
АРШЕД	мр
АРШЕН	мр
АРШИ	мр-жр
АРШИК	мр
АРШИР	мр
АРШОК	мр
АРЩАВИР	мр
АРЩАК	мр
АРЫСЛАН	мр
АРЫСТАМБЕК	мр
АРЫСТАН	мр
АРЬЕ	мр
АРЬЯН	мр
АРЬЯНА	жр
АРЭГА	жр
АРЭН	мр
АРЮНА	жр
АРЯН	мр
АРЯНА	жр
АСААД	мр
АСААТ	мр
АСАБАЛИ	мр
АСАД	мр
АСАДУЛ	мр
АСАДУЛА	мр
АСАДУЛЛ	мр
АСАДУЛЛА	мр
АСАДУЛЛАХ	мр
АСАДУЛЛО	мр
АСАДУР	мр
АСАИ	мр
АСАЙ	мр
АСАЛИ	мр
АСАЛЬ	мр
АСАМ	мр
АСАМБЕК	мр
АСАН	мр
АСАНАЛИ	мр
АСАНБЕГ	мр
АСАНБЕК	мр
АСАНБОЙ	мр
АСАНЕТ	мр
АСАННА	жр
АСАР	мр
АСАТ	мр
АСАТУЛА	жр
АСАТУЛЛА	мр
АСАТУЛЛО	мр
АСАТУР	мр
АСАФ	мр
АСАФИЙ	мр
АСВАДУР	мр
АСВАЛЬД	мр
АСВАН	мр
АСВАР	мр
АСГАР	мр
АСГАТ	мр
АСГАТУЛА	жр
АСГАТУЛЛА	мр
АСДАН	мр
АСЕД	мр
АСЕДУЛЛА	мр
АСЕЙ	мр
АСЕЛЬ	жр
АСЕЛЬДАР	мр
АСЕЛЬДЕР	мр
АСЕМ	жр
АСЕН	мр
АСЕНА	жр
АСЕНЕ	жр
АСЕНЕФА	жр
АСЕНИЯ	жр
АСЕТ	мр
АСЕТУР	мр
АСЕФ	мр
АСЕЯ	жр
АСИАТ	мр
АСИБЕ	жр
АСИДА	жр
АСИЕТ	мр
АСИЙ	мр
АСИК	мр
АСИЛА	жр
АСИЛДАР	мр
АСИЛИЙ	мр
АСИЛХАН	мр
АСИЛХОН	мр
АСИЛЬДАР	мр
АСИЛЬДЕР	мр
АСИЛЯ	жр
АСИМ	мр
АСИМА	жр
АСИМАН	мр
АСИНА	жр
АСИНАТ	мр
АСИНИЯ	жр
АСИР	мр
АСИС	мр
АСИСА	жр
АСИФ	мр
АСИЯТ	мр
АСКАД	мр
АСКАНАЗ	мр
АСКАНИЯ	жр
АСКАР	мр
АСКАРБЕК	мр
АСКАРБИЙ	мр
АСКАРД	мр
АСКАТ	мр
АСКЕРАЛИ	мр
АСКЕРБИ	мр
АСКЕРБИЙ	мр
АСКИНАЗ	мр
АСКИТРИЯ	жр
АСКЛИАДА	жр
АСКОЛЬД	мр
АСКЯР	мр
АСЛ	мр
АСЛАМ	мр
АСЛАМБЕГ	мр
АСЛАМБЕК	мр
АСЛАН	мр
АСЛАНА	жр
АСЛАНБЕГ	мр
АСЛАНБЕК	мр
АСЛАНБЕЧ	мр
АСЛАНХАН	мр
АСЛАХАН	мр
АСЛИ	мр
АСЛИДДИН	мр
АСЛИК	мр
АСЛИЯ	жр
АСЛОМБЕК	мр
АСЛОН	мр
АСЛУДИН	мр
АСЛЯМ	мр
АСМАБИКА	жр
АСМАН	мр
АСМАР	мр
АСМАРА	жр
АСМАТ	мр
АСМАТИ	мр
АСМЕРАЛЬДА	жр
АСМЕТ	мр
АСМИН	мр
АСМИНА	жр
АСМИР	мр
АСМИРАЛЬДА	жр
АСНА	жр
АСНЕЛЬДА	жр
АСНИК	мр
АСО	мр
АСОМИДДИН	мр
АСОМИДИН	мр
АСОН	мр
АСПАЗИЙ	мр
АСПАЗИЯ	жр
АСПАРУХ	мр
АСПРАМ	мр
АСПУРАК	мр
АСРАР	мр
АСРАТ	мр
АСРЕТ	мр
АСРИ	мр
АСРОЛ	мр
АСРОР	мр
АССААД	мр
АССАД	мр
АССАН	мр
АССАНА	жр
АССАФ	мр
АССЕДУЛЛ	мр
АССИНА	жр
АССИР	мр
АССИЯ	жр
АССО	мр
АССОЛЬ	жр
АССЯ	жр
АСТА	жр
АСТАМУР	мр
АСТАН	мр
АСТАНДА	жр
АСТАП	мр
АСТАСИЯ	жр
АСТАФИЙ	мр
АСТАХ	мр
АСТАХИК	мр
АСТГИК	мр
АСТЕМИР	мр
АСТЕРИЙ	мр
АСТИК	мр
АСТИНА	жр
АСТИЧИК	мр
АСТР	мр
АСТРИДА	жр
АСТРИКА	жр
АСТХИК	мр
АСТХИН	мр
АСТЧИК	мр
АСУ	мр
АСУАТ	мр
АСУЛА	жр
АСФАН	мр
АСФАНДИЯР	мр
АСФАР	мр
АСФАТ	мр
АСФИР	мр
АСФИЯ	жр
АСХАБ	мр
АСХАБАЛИ	мр
АСХАБЖАМАЛ	мр
АСХАД	мр
АСХАР	мр
АСХАРБЕК	мр
АСХАТ	мр
АСЦАТУР	мр
АСЫЛ	мр-жр
АСЫЛБЕК	мр
АСЫЛБИКА	жр
АСЫЛГАРЕЙ	мр
АСЫЛКАН	мр
АСЫЛХАН	мр
АСЫМ	мр
АСЫЯ	жр
АСЬЕ	мр
АСЬКА	жр
АСЬМА	жр
АСЬЯ	жр
АСЭФ	мр
АСЯ	жр
АСЯТ	мр
АТА	мр
АТАБАБА	мр
АТАБАЙ	мр
АТАБАЛА	мр
АТАБЕК	мр
АТАВ	мр
АТАГЕЛДИ	мр
АТАДЖАН	мр
АТАЖАН	мр
АТАЙ	мр
АТАКАН	мр
АТАКИШИ	мр
АТАЛ	мр
АТАЛАЙ	мр
АТАЛИЯ	жр
АТАЛЛА	мр
АТАМОГЛАН	мр
АТАМУРАД	мр
АТАМУРАТ	мр
АТАМША	жр
АТАНАЗАР	мр
АТАНАС	мр
АТАНАСИОС	мр
АТАНЕС	мр
АТАР	мр
АТАУЛА	жр
АТАУЛЛА	мр
АТАФЬЯ	жр
АТАХАН	мр
АТАШ	мр
АТЕИНА	жр
АТЕЛИНА	жр
АТЕЛЛО	мр
АТЕФ	мр
АТЕШ	мр
АТИГ	мр
АТИК	мр
АТИКА	жр
АТИКУЛ	мр
АТИКУЛЛА	мр
АТИКУР	мр
АТИЛА	жр
АТИЛИО	мр
АТИЛИЯ	жр
АТИЛЛ	мр
АТИЛЛА	мр
АТИЛЛО	мр
АТИЛЯ	жр
АТИН	мр
АТИР	мр
АТИРА	жр
АТИС	мр
АТИСЛАВ	мр
АТИФ	мр
АТО	мр
АТОБЕК	мр
АТОБУЛЛО	мр
АТОЛ	мр
АТОЛИЙ	мр
АТОМОГЛАН	мр
АТОН	мр
АТОНИДА	жр
АТОНИНА	жр
АТОС	мр
АТОТ	мр
АТРАФ	мр
АТРЕМ	мр
АТТАМ	мр
АТТИЛ	мр
АТТИЛА	жр
АТТИЛИО	мр
АТТОКУР	мр
АТУЛ	мр
АТУР	мр
АТХАМ	мр
АТХАР	мр
АТХЕН	мр
АТЫФ	мр
АУБЕКИР	мр
АУГЕНИЮС	мр
АУГУСТ	мр
АУГУСТИН	мр
АУГУСТИНАС	мр
АУГУСТИНЕ	жр
АУГУСТО	мр
АУДЕЛИЯ	жр
АУДРА	жр
АУДРИС	мр
АУДРИУС	мр
АУДРОНА	жр
АУДРОНЕ	жр
АУДРЮС	мр
АУЕС	мр
АУНИ	мр
АУРЕЛ	мр
АУРЕЛИ	мр
АУРЕЛИАН	мр
АУРЕЛИЙ	мр
АУРЕЛИО	мр
АУРЕЛИУ	мр
АУРЕЛИЯ	жр
АУРЕЛЬ	жр
АУРЕЛЬЯ	жр
АУРЕЛЯ	жр
АУРЕН	мр
АУРИКА	жр
АУРИКО	мр
АУРИЛ	мр
АУРИЛИЯ	жр
АУРИНА	жр
АУРИЯ	жр
АУРОРА	жр
АУС	мр
АУСМА	жр
АУСТА	жр
АУСТРА	жр
АУФА	жр
АУХАТ	мр
АУШРА	жр
АФАГ	мр
АФАН	мр
АФАНА	жр
АФАНАС	мр
АФАНАСИЙ	мр
АФАНАСИЯ	жр
АФАНАСЬЯ	жр
АФАНДИ	мр
АФАНИСИЙ	мр
АФАНОСИЙ	мр
АФАСИЯ	жр
АФАТ	мр
АФАЯТ	мр
АФГАН	мр
АФГОН	мр
АФЕНОГЕН	мр
АФЕТ	мр
АФЗАЛ	мр
АФИ	мр
АФИГ	мр
АФИГА	жр
АФИДА	жр
АФИЗ	мр
АФИЗА	жр
АФИК	мр
АФИЛА	жр
АФИЛИЯ	жр
АФИЛЯ	жр
АФИМ	мр
АФИМИЯ	жр
АФИМЬЯ	жр
АФИНА	жр
АФИНОГЕН	мр
АФИОНИЯ	жр
АФИС	мр
АФИСА	жр
АФИСАТ	мр
АФИТ	мр
АФИФ	мр
АФИФА	жр
АФИФЕ	жр
АФИФИЯ	жр
АФИФЯ	жр
АФИЧ	мр
АФИЯ	жр
АФИЯДДИН	мр
АФИЯТ	мр
АФКА	жр
АФЛАДДИН	мр
АФЛАТУЛ	мр
АФЛАТУН	мр
АФЛЯТ	мр
АФЛЯХ	мр
АФОНАС	мр
АФОНАСИЙ	мр
АФОНАСИЯ	жр
АФОНИЙ	мр
АФОНЯ	мр
АФРАДДИН	мр
АФРАИЛ	мр
АФРАНИЙ	мр
АФРАТ	мр
АФРЕМ	мр
АФРИДИ	мр
АФРИКАН	мр
АФРИКАНТ	мр
АФРОДИТА	жр
АФРОИМ	мр
АФРОСИАБ	мр
АФРОСИМ	мр
АФРОСИНЬЯ	жр
АФРУЗ	мр
АФСАЛ	мр
АФСАЛАДДИН	мр
АФСАНА	жр
АФСАНЕ	жр
АФСАР	мр
АФСУН	мр
АФТАЛИНА	жр
АФТАН	мр
АФТАНДИЛ	мр
АФТАНДИН	мр
АФТАХ	мр
АФТЕНИЙ	мр
АФТОНДИЛ	мр
АФХАТ	мр
АФШИН	мр
АХАД	мр
АХАДУЛЛА	мр
АХАИТ	мр
АХАТ	мр
АХАТКУЛ	мр
АХБАР	мр
АХВЕРДИ	мр
АХДАН	мр
АХЕД	мр
АХЕМЕД	мр
АХИАД	мр
АХИАР	мр
АХИБ	мр
АХИД	мр
АХИЙ	мр
АХИЛЕС	мр
АХИЛЛЕС	мр
АХИМ	мр
АХИМИЯ	жр
АХИТ	мр
АХИЯД	мр
АХИЯР	мр
АХИЯТ	мр
АХКАМ	мр
АХКАМУТДИН	мр
АХКЯМ	мр
АХЛАМ	жр
АХЛИДИН	мр
АХЛИМА	жр
АХЛИМАН	мр
АХМАД	мр
АХМАДАЛИ	мр
АХМАДБЕК	мр
АХМАДЖАН	мр
АХМАДЖОН	мр
АХМАДРЕЗА	жр
АХМАДУЛА	жр
АХМАДУЛЛА	мр
АХМАДХАН	мр
АХМАДШАХ	мр
АХМАДШОХ	мр
АХМАР	мр
АХМАТ	мр
АХМАТГАЛИ	мр
АХМАТЖАН	мр
АХМАТНУР	мр
АХМАТША	жр
АХМЕД	мр
АХМЕД-ХАН	мр
АХМЕДАГА	мр
АХМЕДАЛИ	мр
АХМЕДАЛЫ	мр
АХМЕДБЕК	мр
АХМЕДГАЛИ	мр
АХМЕДЖАН	мр
АХМЕДЗЯН	мр
АХМЕДИ	мр
АХМЕДУЛА	мр
АХМЕДУЛАХ	мр
АХМЕДХАН	мр
АХМЕЙ	мр
АХМЕМАН	мр
АХМЕР	мр
АХМЕТ	мр
АХМЕТАЛИМ	мр
АХМЕТВАЛИ	мр
АХМЕТЖАН	мр
АХМЕТЗИЛ	мр
АХМЕТЗИЯ	жр
АХМЕТЗЯН	мр
АХМЕТСАФА	жр
АХМЕТША	жр
АХМЕТШАРИП	мр
АХМИД	мр
АХМИТ	мр
АХМУРАТ	мр
АХМЯР	мр
АХМЯТ	мр
АХМЯТША	жр
АХМЯТЬ	мр
АХНАВ	мр
АХНАД	мр
АХНАР	мр
АХНАФ	мр
АХНЕТ	мр
АХОН	мр
АХРА	жр
АХРАЛ	мр
АХРОР	мр
АХРОРИДДИН	мр
АХРОРКУЛ	мр
АХСАН	мр
АХСАПЕТ	мр
АХСАР	мр
АХСАРБЕГ	мр
АХСАРБЕК	мр
АХСАРТАГ	мр
АХСЕН	мр
АХТАМ	мр
АХТАМЯН	мр
АХТАН	мр
АХТАНГ	мр
АХТАР	мр
АХТАРИ	мр
АХТЕМ	мр
АХТЕМИР	мр
АХТЕН	мр
АХТИБАР	мр
АХТИМ	мр
АХТЯМ	мр
АХУДАР	мр
АХУН	мр
АХУНД	мр
АХУНЗЯН	мр
АХУРБЕК	мр
АХШАР	мр
АЦА	мр
АЦАМАЗ	мр
АЦИ	мр
АЦО	мр
АЧИКО	мр
АЧИЛ	мр
АШАК	мр
АШАР	мр
АШАТ	мр
АШВАНИ	мр
АШГАТ	мр
АШЕР	мр
АШЕТ	мр
АШИК	мр
АШИМ	мр
АШИР	мр
АШИРА	жр
АШИРБАЙ	мр
АШИРБЕРДИ	мр
АШИРБУ	жр
АШИРМУРАД	мр
АШИРМУРАТ	мр
АШИШ	мр
АШКАН	мр
АШКАР	мр
АШМЕ	мр
АШОГ	мр
АШОД	мр
АШОК	мр
АШОН	мр
АШОТ	мр
АШОТИК	мр
АШРАП	мр
АШРАФ	мр
АШРЕФ	мр
АШУ	мр
АШУКУЛЛА	мр
АШУР	мр
АШУРА	жр
АШУРАЛИ	мр
АШУРБАЙ	мр
АШУРБЕК	мр
АШУРЕЛИ	мр
АШУТОШ	мр
АШФАК	мр
АШХАН	мр
АШХАРИК	мр
АШХЕНА	жр
АШХЕНИК	мр
АШХИН	мр
АШШУР	мр
АЭЛИНА	жр
АЭЛИТ	мр
АЭЛИТА	жр
АЭЛИТТА	жр
АЭЛЛА	жр
АЭЛЛИТА	жр
АЮБ	мр
АЮЛИЯ	жр
АЮНА	жр
АЮП	мр
АЯ	жр
АЯГОЗ	мр
АЯЗ	мр
АЯЗХАН	мр
АЯНА	жр
АЯР	мр
АЯСУ	мр
БААДУР	мр
БАБА-ЯГА	жр
БАБАК	мр
БАБАМУРАД	мр
БАБАМУРАТ	мр
БАГАВУДИН	мр
БАГАДДИН	мр
БАГАДИР	мр
БАГАДУР	мр
БАГАДЫР	мр
БАГАУДИН	мр
БАГАУТДИН	мр
БАГДАН	мр
БАГДАНА	жр
БАГИ	мр
БАГИЛЯ	жр
БАГИР	мр
БАГИРА	жр
БАГИТ	мр
БАГИТЖАН	мр
БАГИШ	мр
БАГИЯ	жр
БАГОМЕД	мр
БАГРАМ	мр
БАГРАТ	мр
БАДАНА	жр
БАДЕРТДИН	мр
БАДИЛЯ	жр
БАДИЯ	жр
БАДМАЙ	мр
БАДРИ	мр
БАДРИЙ	мр
БАДРУДДИН	мр
БАДРУДИ	мр
БАДРУДИН	мр
БАДРУТДИН	мр
БАЖАН	мр
БАЖЕНА	жр
БАЖЕНЯ	жр
БАЗИЙ	мр
БАЗИК	мр
БАЗИЛ	мр
БАЗИЛИЯ	жр
БАИР	мр
БАЙ-АЛИ	мр
БАЙАНДУР	мр
БАЙБАКТЫ	мр
БАЙБУЛАТ	мр
БАЙГАЗ	мр
БАЙГИНАТ	мр
БАЙДАН	мр
БАЙДУЛЛА	мр
БАЙДУЛЛЬ	мр
БАЙМИРЗА	мр
БАЙМУРАД	мр
БАЙМУРАТ	мр
БАЙМУРЗА	мр
БАЙОГЛАН	мр
БАЙРАМ	мр
БАЙРАМКИЗ	мр
БАЙРАММУРАД	мр
БАЙРАММУХАМЕД	мр
БАЙРАН	мр
БАЙСАНГУР	мр
БАЙСУЛТАН	мр
БАЙТЕМИР	мр
БАЙХАН	мр
БАЙЫР	мр
БАКИР	мр
БАКРУЗ	мр
БАКТИЯР	мр
БАКТУРДИ	мр
БАКТЫГУЛЬ	мр
БАКУР	мр
БАКЫР	мр
БАКЫТ	мр-жр
БАКЫТБЕК	мр
БАКЫТЖАН	мр
БАЛАБЕГ	мр
БАЛАБЕЙ	мр
БАЛАБЕК	мр
БАЛАГАРДАШ	мр
БАЛАГАСАН	мр
БАЛАГУСЕЙН	мр
БАЛАКЕРИМ	мр
БАЛАКИЗ	мр
БАЛАСАН	мр
БАЛАСАР	мр
БАЛАСУЛТАН	мр
БАЛАХМЕД	мр
БАЛДАН	мр
БАЛТАБАЙ	мр
БАЛТАБЕК	мр
БАЛЬТ	мр
БАРАБАШ	мр
БАРАБАША	жр
БАРАК	мр
БАРАН	мр
БАРБАРА	жр
БАРБАРАШ	мр
БАРНИ	мр
БАРРИ	мр
БАРТ	мр
БАРТАН	мр
БАРТОЛОМЕЙ	мр
БАРЫЙ	мр
БАСАМ	мр
БАСИМ	мр
БАСИР	мр
БАТАЛ	мр
БАТИРБЕК	мр
БАТУХАН	мр
БАТЫЙ	мр
БАТЫР	мр
БАТЫР-БЕК	мр
БАТЫРАЛИ	мр
БАТЫРБЕК	мр
БАТЫРБУЛАТ	мр
БАТЫРДЖАН	мр
БАТЫРША	жр
БАУДИН	мр
БАХАДЫР	мр
БАХЛУЛ	мр
БАХМУТ	мр
БАХОДУР	мр
БАХТЕМИР	мр
БАХТИЕР	мр
БАХТИЯР	мр
БАХТУРАС	мр
БАХУР	мр
БАХУС	мр
БАХЫТ	мр-жр
БАХЫТГУЛЬ	жр
БАХЫТЖАН	мр
БАШАР	мр
БАШИР	мр
БАЯЗ	мр
БАЯЗИТ	мр
БАЯР	мр
БЕАТА	жр
БЕАТРИС	жр
БЕАТРИСА	жр
БЕАТРИЧЕ	жр
БЕАТТА	жр
БЕГМУРАТ	мр
БЕГМУРОД	мр
БЕГНАЗАР	мр
БЕДРЕТДИН	мр
БЕЖАНА	жр
БЕКЗАДА	жр
БЕКЗАТ	мр
БЕКЗОД	мр
БЕКИР	мр
БЕКМУРЗА	мр
БЕКМУХАМАД	мр
БЕКМУХАМБЕТ	мр
БЕКМУХАМЕД	мр
БЕКНАЗАР	мр
БЕКСОЛТАН	мр
БЕКСУЛТАН	мр
БЕКТЕМИР	мр
БЕКТИМАР	мр
БЕКХАН	мр
БЕЛА	жр
БЕЛИНА	жр
БЕЛЛА	жр
БЕЛЛОЧКА	жр
БЕМБЕЙ	мр
БЕМБУЛАТ	мр
БЕМБЯ	мр
БЕН	мр
БЕНА	мр
БЕНАМИН	мр
БЕНДЖАМЕН	мр
БЕНДЖАМИН	мр
БЕНЕДИКТ	мр
БЕНЕДИКТА	жр
БЕНЕДИКТАС	мр
БЕНИАМИН	мр
БЕНЦИАН	мр
БЕНЦИОН	мр
БЕНЯ	мр
БЕРГУТ	мр
БЕРЕНИКА	жр
БЕРИК	мр
БЕРИКХАН	мр
БЕРМЕТ	мр
БЕРНАДЕТА	жр
БЕРНАДЕТТА	жр
БЕРНАДИЯ	жр
БЕРНАНД	мр
БЕРНАР	мр
БЕРНАРА	жр
БЕРНАРД	мр
БЕРНАРДА	жр
БЕРНГАРД	мр
БЕРНХАРД	мр
БЕРС	мр
БЕРТ	мр
БЕРТА	жр
БЕРТИ	жр
БЕРТИНА	жр
БЕРТОЛОН	мр
БЕРТОЛЬД	мр
БЕРТОЛЬДА	жр
БЕРТОН	мр
БЕРТРАМ	мр
БЕРТРАН	мр
БЕРТРАНД	мр
БЕСЛАН	мр
БЕССАРАБ	мр
БЕТСИ	жр
БЕТЯ	жр
БЕХАН	мр
БЕХРУЗ	мр
БИАДА	жр
БИАНА	жр
БИАНКА	жр
БИАННА	жр
БИАСЛАН	мр
БИАТА	жр
БИАТРИСА	жр
БИБИГУЛЬ	жр
БИБИКАМАЛ	мр
БИБИНУР	мр
БИДЗИН	мр
БИДЗИНА	жр
БИЙМУРЗА	мр
БИЙСОЛТАН	мр
БИКБАЙ	мр
БИКБУЛАТ	мр
БИЛАЛ	мр
БИЛАН	мр
БИЛЕЛЬ	мр
БИЛЛ	мр
БИНЬЯМИН	мр
БИРГЕР	мр
БИРКУН	мр
БИСЛАН	мр
БИЧИКО	мр
БИЯКАЙ	мр
БЛЯМ	мр
БОБ	мр
БОББИ	мр
БОБИ	мр
БОБО	мр
БОБОМУРАТ	мр
БОБОМУРОД	мр
БОБОНАЗАР	мр
БОБОХАН	мр
БОБОШЕР	мр
БОБУРЖОН	мр
БОГАДУР	мр
БОГДАН	мр
БОГДАНА	жр
БОГДАНАС	мр
БОГДАНИЯ	жр
БОГДАННА	жр
БОГДАСАР	мр
БОГОДАР	мр
БОГОЛЮБ	мр
БОГОМИЛА	жр
БОГОМИР	мр
БОГОС	мр
БОГРАТ	мр
БОГУМИЛ	мр
БОГУМИЛА	жр
БОГУСЛАВ	мр
БОГУСЛАВА	жр
БОДАН	мр
БОЕСЛАВ	мр
БОЖАНА	жр
БОЖЕНА	жр
БОЖИДАР	мр
БОЖИН	мр
БОЛЕСАВ	мр
БОЛЕСЛАВ	мр
БОЛЕСЛАВА	жр
БОЛИСЛАВ	мр
БОЛИСЛАВА	жр
БОЛОБЕК	мр
БОЛОТБЕК	мр
БОНИСЛАВ	мр
БОНИСЛАВА	жр
БОНИФАЦИЙ	мр
БОРАЙ	мр
БОРЕСЛАВ	мр
БОРИК	мр
БОРИНА	жр
БОРИС	мр
БОРИСАС	мр
БОРИСЛАВ	мр
БОРИСЛАВА	жр
БОРИЯ	жр
БОРЬКА	мр
БОРЯ	мр
БОТАГОЗ	жр
БОТАГОС	жр
БОХОДИР	мр
БОЯН	мр
БОЯНА	жр
БОЯР	мр
БРАГИМ	мр
БРАЙАН	мр
БРАЙНА	жр
БРАНДТ	мр
БРАНИСЛАВ	мр
БРАНИСЛАВА	жр
БРЕНДОН	мр
БРЕНТ	мр
БРИГИДА	жр
БРИГИТА	жр
БРИГИТТА	жр
БРИДЖЕНДРА	жр
БРИЙ	мр
БРИТНИ	жр
БРОЙНА	жр
БРОНЕСЛАВ	мр
БРОНЕСЛАВА	жр
БРОНИСЛАВ	мр
БРОНИСЛАВА	жр
БРОНИСЛАВАС	мр
БРОНЯ	жр
БРУНО	мр
БРЭД	мр
БРЮС	мр
БУБА	мр
БУБАКАР	мр
БУГАДИН	мр
БУГАУДИН	мр
БУГДАН	мр
БУГРИМ	мр
БУДАЖАП	мр
БУДИМИР	мр
БУДИОН	мр
БУДУЛАЙ	мр
БУЗДЖИГИТ	мр
БУЗЖИГИТ	мр
БУЛАЛ	мр
БУЛАН	мр
БУЛАТ	мр
БУЛАХ	мр
БУЛАЧ	мр
БУЛАШ	мр
БУНИМ	мр
БУРАНБАЙ	мр
БУРАНГУЛ	мр
БУРАСТАН	мр
БУРАТИНО	мр
БУРГ	мр
БУРГАН	мр
БУРУЛ	жр
БУРУЛКАН	мр
БУРХАН	мр
БУТРОС	мр
БУХАРБАЙ	мр
БХАРТРИХАРИ	мр
БЭЛА	жр
БЭЛЗА	жр
БЭЛЛА	жр
БЭЛЯ	жр
БЭРТА	жр
БЯШИМ	мр
ВААГНА	жр
ВААН	мр
ВАВЖИНЕЦ	мр
ВАВИЛ	мр
ВАВИЛА	мр
ВАВИЛИЙ	мр
ВАГАН	мр
ВАГАРШАК	мр
ВАГЕ	мр
ВАГИЗ	мр
ВАГИЗА	жр
ВАГИС	мр
ВАГИСТ	мр
ВАГИТ	мр
ВАГИФ	мр
ВАГНЕР	мр
ВАГНОР	мр
ВАГОРШАК	мр
ВАГРАМ	мр
ВАГРАН	мр
ВАГУБ	мр
ВАГЫЙЗ	мр
ВАДЕЛЕН	мр
ВАДЕЛИН	мр
ВАДЕРИЙ	мр
ВАДЖИБ	мр
ВАДЖИД	мр
ВАДЖИХ	мр
ВАДИД	мр
ВАДИЙ	мр
ВАДИК	мр
ВАДИМ	мр
ВАДИМА	жр
ВАДИМИР	мр
ВАДИН	мр
ВАДИСЛАВ	мр
ВАДЛЕЙ	мр
ВАДЛЕН	мр
ВАДЛЕНТИН	мр
ВАДУД	мр
ВАДУТ	мр
ВАЗГЕН	мр
ВАЗЕР	мр
ВАЗИЗ	мр
ВАЗИЛ	мр
ВАЗИН	мр
ВАЗИПАТ	мр
ВАЗИР	мр
ВАЗИРХАН	мр
ВАЗИФА	жр
ВАЗИХ	мр
ВАЗЫК	мр
ВАИД	мр
ВАИЛИЙ	мр
ВАИНА	жр
ВАЙРАМ	мр
ВАЙС	мр
ВАЙЦЕХ	мр
ВАКИЛ	мр
ВАКИЛЬ	мр
ВАКИЛЯ	жр
ВАКЛЕНТИНА	жр
ВАКТОР	мр
ВАКТОРИЯ	жр
ВАКУЛА	жр
ВАКУЛЬ	жр
ВАЛАДДИН	мр
ВАЛАДИН	мр
ВАЛАНТИН	мр
ВАЛАНТИНА	жр
ВАЛАРИЙ	мр
ВАЛДАС	мр
ВАЛДЕМАРАС	мр
ВАЛДЕНТИНА	жр
ВАЛДЕРИЙ	мр
ВАЛДИС	мр
ВАЛЕВИЙ	мр
ВАЛЕГ	мр
ВАЛЕГИЙ	мр
ВАЛЕЙ	мр
ВАЛЕКИЙ	мр
ВАЛЕН	мр
ВАЛЕНА	жр
ВАЛЕНГТИН	мр
ВАЛЕНГТИНА	жр
ВАЛЕНИЙ	мр
ВАЛЕНИН	мр
ВАЛЕНИНА	жр
ВАЛЕНИТА	жр
ВАЛЕННТИНА	жр
ВАЛЕНСА	мр
ВАЛЕНСЬ	мр
ВАЛЕНТ	мр
ВАЛЕНТА	жр
ВАЛЕНТИАНА	жр
ВАЛЕНТИЙ	мр
ВАЛЕНТИН	мр
ВАЛЕНТИНА	жр
ВАЛЕНТИНАС	мр
ВАЛЕНТИНАТ	мр
ВАЛЕНТИННА	жр
ВАЛЕНТИРА	жр
ВАЛЕНТИТА	жр
ВАЛЕНТУЛЯ	жр
ВАЛЕРА	мр
ВАЛЕРИ	мр-жр
ВАЛЕРИА	жр
ВАЛЕРИАН	мр
ВАЛЕРИАННА	жр
ВАЛЕРИЙ	мр
ВАЛЕРИК	мр
ВАЛЕРИКА	жр
ВАЛЕРИНА	жр
ВАЛЕРИОНАС	мр
ВАЛЕРИУС	мр
ВАЛЕРИЯ	жр
ВАЛЕРИЯН	мр
ВАЛЕРКА	мр
ВАЛЕРЬЯН	мр
ВАЛЕРЯН	мр
ВАЛЕСКА	жр
ВАЛЕТИЙ	мр
ВАЛЕТИН	мр
ВАЛЕТИНА	жр
ВАЛЕТНИНА	жр
ВАЛЕФТИНА	жр
ВАЛЕХ	мр
ВАЛЕЧКА	жр
ВАЛИД	мр
ВАЛИДА	жр
ВАЛИДДИН	мр
ВАЛИДЖАН	мр
ВАЛИДЖОН	мр
ВАЛИЙ	мр
ВАЛИКА	жр
ВАЛИКО	мр
ВАЛИЛИЙ	мр
ВАЛИМ	мр
ВАЛИМА	жр
ВАЛИМИР	мр
ВАЛИМУХАМЕД	мр
ВАЛИН	мр
ВАЛИНА	жр
ВАЛИТА	жр
ВАЛИУЛЛА	мр
ВАЛИХАН	мр
ВАЛОЕРИЙ	мр
ВАЛЬВИНА	жр
ВАЛЬДЕК	мр
ВАЛЬДЕМА	жр
ВАЛЬДЕМАР	мр
ВАЛЬДЕМАРА	жр
ВАЛЬДИМАР	мр
ВАЛЬДИМАРАС	мр
ВАЛЬДИНА	жр
ВАЛЬКА	мр
ВАЛЬМИРА	жр
ВАЛЬТЕР	мр
ВАЛЯ	жр
ВАЛЯДДИН	мр
ВАНАТОЛИЙ	мр
ВАНГ	мр
ВАНДА	жр
ВАНДАН	мр
ВАНДАНА	жр
ВАНЕС	мр
ВАНЕССА	жр
ВАНЕЧКА	мр
ВАНИАМИН	мр
ВАНИК	мр
ВАНИНА	жр
ВАНИФАНТИЙ	мр
ВАНИФАТИЙ	мр
ВАНИЯ	жр
ВАНО	мр
ВАНТИНА	жр
ВАНЦЕТИЙ	мр
ВАНЬКА	мр
ВАНЯ	мр
ВАРАСТАТ	мр
ВАРВАРА	жр
ВАРДАН	мр
ВАРДКЕС	мр
ВАРДУА	мр
ВАРЕАНОФИЙ	мр
ВАРИЙ	мр
ВАРИК	мр
ВАРИНКА	жр
ВАРЛАМ	мр
ВАРЛАМИЙ	мр
ВАРОНИКА	жр
ВАРСАНОФИЙ	мр
ВАРСОНОФИЙ	мр
ВАРТАЗАР	мр
ВАРТАН	мр
ВАРТКЕЗ	мр
ВАРФАЛАМЕЙ	мр
ВАРФАЛОМЕЙ	мр
ВАРФОЛОМЕЙ	мр
ВАРШАМ	мр
ВАРЬЯ	жр
ВАРЯ	жр
ВАСГЕН	мр
ВАСЕЛИНА	жр
ВАСЕЛИСА	жр
ВАСЕНА	жр
ВАСИДИЙ	мр
ВАСИЙ	мр
ВАСИЛ	мр
ВАСИЛА	жр
ВАСИЛДИЙ	мр
ВАСИЛЕНА	жр
ВАСИЛИЙ	мр
ВАСИЛИКА	жр
ВАСИЛИНА	жр
ВАСИЛИСА	жр
ВАСИЛТИЙ	мр
ВАСИЛЬ	мр
ВАСИМ	мр
ВАСИФ	мр
ВАСЛАВ	мр
ВАСЛИЯ	жр
ВАСНИЯ	жр
ВАССА	жр
ВАССИЛ	мр
ВАССИМ	мр
ВАСТИЛИЙ	мр
ВАСФИЕ	жр
ВАСЫЛЬ	мр
ВАСЬКА	мр
ВАСЮТА	мр
ВАСЯ	мр
ВАТАЛИЙ	мр
ВАТИСЛАВ	мр
ВАТИСЛАВА	жр
ВАТСЛАВ	мр
ВАФА	мр
ВАХАБ	мр
ВАХИД	мр
ВАХИМ	мр
ВАХИР	мр
ВАХИТ	мр
ВАХОБ	мр
ВАХТАНГ	мр
ВАХТАНГИ	мр
ВАХТАНШ	мр
ВАХУР	мр
ВАЦЛАВ	мр
ВАЦЛАВА	жр
ВАЦЛАВАС	мр
ВАЦЛОВ	мр
ВАЦСЛАВА	жр
ВАЧИР	мр
ВАЭЛЬ	мр
ВГЕНИЙ	мр
ВЕАЛЕТА	жр
ВЕАЛЕТТА	жр
ВЕДЕНЕЙ	мр
ВЕЙКО	мр
ВЕЛЕНТИН	мр
ВЕЛЕНТИНА	жр
ВЕЛЕРИЙ	мр
ВЕЛИ	мр
ВЕЛИЗАР	мр
ВЕЛИКАНИДА	жр
ВЕЛИМАМЕД	мр
ВЕЛИМЕТ	мр
ВЕЛИМИР	мр
ВЕЛИМУРАД	мр
ВЕЛИНА	жр
ВЕЛИОР	мр
ВЕЛИСЛАВ	мр
ВЕЛИТА	жр
ВЕЛИЮЛЛА	жр
ВЕЛИЯ	жр
ВЕЛИЯДДИН	мр
ВЕЛЛА	жр
ВЕЛЛО	мр
ВЕЛОРА	жр
ВЕЛОРИЙ	мр
ВЕЛОРИЯ	жр
ВЕЛЬМИНА	жр
ВЕЛЬМИРА	жр
ВЕЛЬТА	жр
ВЕНАДИЙ	мр
ВЕНАЙ	мр
ВЕНАЛИЙ	мр
ВЕНАРА	жр
ВЕНАРИЙ	мр
ВЕНАРИЯ	жр
ВЕНДЕЛИН	мр
ВЕНЕАМИН	мр
ВЕНЕГДИТ	мр
ВЕНЕДИЙ	мр
ВЕНЕДИКТ	мр
ВЕНЕДИКТА	жр
ВЕНЕДИМ	мр
ВЕНЕКДИТ	мр
ВЕНЕРА	жр
ВЕНЕРАНДА	жр
ВЕНИАМИН	мр
ВЕНИАМИНА	жр
ВЕНИДИКТ	мр
ВЕНИНА	жр
ВЕНИРА	жр
ВЕНИСЛАВ	мр
ВЕННАДИЙ	мр
ВЕНОР	мр
ВЕНСАН	мр
ВЕНТАМИН	мр
ВЕНХВИЯ	жр
ВЕНЦЕСЛАВ	мр
ВЕНЦЕСЛАВА	жр
ВЕНЦИСЛАВ	мр
ВЕНЬКА	мр
ВЕНЯ	мр
ВЕОНИД	мр
ВЕРА	жр
ВЕРАИДА	жр
ВЕРАНА	жр
ВЕРАНИКА	жр
ВЕРВАРА	жр
ВЕРГЕНИЯ	жр
ВЕРГИЛИЙ	мр
ВЕРГИЛИЯ	жр
ВЕРГИНА	жр
ВЕРГИНИЯ	жр
ВЕРГУША	жр
ВЕРДЖИНИЯ	жр
ВЕРЕМЕЙ	мр
ВЕРЕНЕЯ	жр
ВЕРЕНИЯ	жр
ВЕРЖИЛИЙ	мр
ВЕРКА	жр
ВЕРНЕР	мр
ВЕРОНИКА	жр
ВЕРОНИНА	жр
ВЕРОНИЯ	жр
ВЕРОСЛАВ	мр
ВЕРОЧКА	жр
ВЕРРА	жр
ВЕРСАВИЯ	жр
ВЕРУНЧИК	жр
ВЕСЕЛИНА	жр
ВЕСИЛА	жр
ВЕСИЛЯ	жр
ВЕСЛАВ	мр
ВЕСЛАВА	жр
ВЕСЛАНА	жр
ВЕСМА	жр
ВЕСМИРА	жр
ВЕСНЯНА	жр
ВЕСТА	жр
ВЕСТАЛИЯ	жр
ВЕСТИСЛАВ	мр
ВЕТА	жр
ВЕТАЛИЙ	мр
ВЕТАЛИНА	жр
ВЕТИСЛАВ	мр
ВЕТОСЛАВ	мр
ВЕЧАСЛАВ	мр
ВЕЧЕСЛАВ	мр
ВЕЧИСЛАВ	мр
ВИАЛЕТА	жр
ВИАЛЕТТА	жр
ВИАЛИЙ	мр
ВИАЛИНА	жр
ВИАННА	жр
ВИАРЕЛ	мр
ВИАТАЛИЙ	мр
ВИАТЛИЙ	мр
ВИАТОР	мр
ВИВТОР	мр
ВИГДОР	мр
ВИДАДИЙ	мр
ВИДАЛИЙ	мр
ВИДИСЛАВ	мр
ВИДОСЛАВ	мр
ВИИАЛИЙ	мр
ВИКА	жр
ВИКЕНТИЙ	мр
ВИКЕНТИЯ	жр
ВИККЕНТИЙ	мр
ВИКОР	мр
ВИКСИТИЙ	мр
ВИКТАЛИЙ	мр
ВИКТАР	мр
ВИКТОИРЯ	жр
ВИКТОИЯ	жр
ВИКТОЛИНА	жр
ВИКТОР	мр
ВИКТОРАВ	мр
ВИКТОРАС	мр
ВИКТОРИА	жр
ВИКТОРИАН	мр
ВИКТОРИЙ	мр
ВИКТОРИН	мр
ВИКТОРИО	мр
ВИКТОРИС	мр
ВИКТОРИЯ	жр
ВИКТОРОИЯ	жр
ВИКТОРОС	мр
ВИКТОРС	мр
ВИКТР	мр
ВИКУЛ	мр
ВИКУЛА	мр
ВИЛАЛИЙ	мр
ВИЛАРИЙ	мр
ВИЛАТИЙ	мр
ВИЛЕМ	мр
ВИЛЕН	мр
ВИЛЕНА	жр
ВИЛЕНИЙ	мр
ВИЛЕНИН	мр
ВИЛЕНИНА	жр
ВИЛЕР	мр
ВИЛИ	мр
ВИЛИАН	мр
ВИЛИЙ	мр
ВИЛИНА	жр
ВИЛИС	мр
ВИЛЛ	мр
ВИЛЛЕМ	мр
ВИЛЛЕН	мр
ВИЛЛЕНА	жр
ВИЛЛИ	мр
ВИЛЛИАМИН	мр
ВИЛЛИАН	мр
ВИЛЛИБАЛЬД	мр
ВИЛЛИЙ	мр
ВИЛЛИНА	жр
ВИЛЛИЯ	жр
ВИЛЛОР	мр
ВИЛЛОРА	жр
ВИЛЛОРИЙ	мр
ВИЛЛЬ	мр
ВИЛЛЬЯМ	мр
ВИЛЛЯ	мр
ВИЛМА	жр
ВИЛОН	мр
ВИЛОНА	жр
ВИЛОР	мр
ВИЛОРД	мр
ВИЛОРИЙ	мр
ВИЛОРИК	мр
ВИЛОРК	мр
ВИЛОТ	мр
ВИЛОЯТ	мр
ВИЛЬ	мр
ВИЛЬВЕТТА	жр
ВИЛЬГЕЛЬМ	мр
ВИЛЬГЕЛЬМАС	мр
ВИЛЬГЕЛЬМИНА	жр
ВИЛЬГЕЛЬМУС	мр
ВИЛЬГЕМИНА	жр
ВИЛЬГЕН	мр
ВИЛЬГЕНИЙ	мр
ВИЛЬДАН	мр
ВИЛЬКЕН	мр
ВИЛЬМА	жр
ВИЛЬМАН	мр
ВИЛЬМАР	мр
ВИЛЬМИНА	жр
ВИЛЬМИР	мр
ВИЛЬНАРА	жр
ВИЛЬЧЕЛЬМИНА	жр
ВИЛЬЯМ	мр
ВИЛЬЯМИН	мр
ВИЛЯРА	жр
ВИНАРИЙ	мр
ВИНИАМИН	мр
ВИНИДИКТ	мр
ВИНИСЛАВ	мр
ВИНЦАС	мр
ВИНЦЕНТ	мр
ВИНЦЕНТИНА	жр
ВИНЦЕНЦИЯ	жр
ВИОЛАНТА	жр
ВИОЛЕНА	жр
ВИОЛЕТТА	жр
ВИОЛИНА	жр
ВИОНОР	мр
ВИОР	мр
ВИОРЕЛ	мр
ВИОРЕЛИЯ	жр
ВИОРЕН	мр
ВИОРИКА	жр
ВИОРИЛ	мр
ВИОРИНА	жр
ВИРАБ	мр
ВИРАЛИЙ	мр
ВИРДЖИНИЯ	жр
ВИРЖИНА	жр
ВИРЖИНИЯ	жр
ВИРМА	жр
ВИРСАВИЯ	жр
ВИСЕНТЕ	мр
ВИССА	жр
ВИССАМ	мр
ВИССАРИАН	мр
ВИССАРИЙ	мр
ВИССАРИОН	мр
ВИТ	мр
ВИТА	жр
ВИТАДИЙ	мр
ВИТАЛИЙ	мр
ВИТАЛИК	мр
ВИТАЛИНА	жр
ВИТАЛИЯ	жр
ВИТАЛЬД	мр
ВИТАС	мр
ВИТАУТ	мр
ВИТАУТАС	мр
ВИТАУТОС	мр
ВИТАУТС	мр
ВИТАША	мр
ВИТЕЛИЙ	мр
ВИТЕНЬКА	мр
ВИТЕР	мр
ВИТЕСЛАВ	мр
ВИТИАЛИЙ	мр
ВИТОЛЬД	мр
ВИТОЛЬДА	жр
ВИТОСЛАВ	мр
ВИТРАС	мр
ВИТТОРИО	мр
ВИТТОРИЯ	жр
ВИТУС	мр
ВИТЧЕСЛАВ	мр
ВИТЧИСЛАВ	мр
ВИТЬКА	мр
ВИТЯ	мр
ВИЦЕНТИНА	жр
ВИШАН	мр
ВИШВАНАТАН	мр
ВЛАД	мр
ВЛАДА	жр
ВЛАДАН	мр
ВЛАДАР	мр
ВЛАДАС	мр
ВЛАДЕК	мр
ВЛАДЕЛЕН	мр
ВЛАДЕЛИН	мр
ВЛАДЕН	мр
ВЛАДЕР	мр
ВЛАДЕСЛАВ	мр
ВЛАДЖИМИР	мр
ВЛАДЖИСЛАВ	мр
ВЛАДИИМИР	мр
ВЛАДИИМР	мр
ВЛАДИЙ	мр
ВЛАДИК	мр
ВЛАДИЛАВ	мр
ВЛАДИЛЕЙ	мр
ВЛАДИЛЕН	мр
ВЛАДИЛЕНА	жр
ВЛАДИЛЕНТ	мр
ВЛАДИЛИН	мр
ВЛАДИЛЛЕН	мр
ВЛАДИЛЬЕН	мр
ВЛАДИМ	мр
ВЛАДИМАР	мр
ВЛАДИМЕР	мр
ВЛАДИМИР	мр
ВЛАДИМИРАС	мр
ВЛАДИМР	мр
ВЛАДИН	мр
ВЛАДИР	мр
ВЛАДИСЛАВ	мр
ВЛАДИСЛАВА	жр
ВЛАДИСМИР	мр
ВЛАДЛЕН	мр
ВЛАДЛЕНА	жр
ВЛАДЛИМИР	мр
ВЛАДМИИР	мр
ВЛАДЩИМИР	мр
ВЛАЖИМИР	мр
ВЛАЛИМИР	мр
ВЛАЛИСЛАВ	мр
ВЛАМИР	мр
ВЛАРИЙ	мр
ВЛАС	мр
ВЛАСИЙ	мр
ВЛАСИМИР	мр
ВЛАСЛАВ	мр
ВЛАСТА	жр
ВЛАСТЕЛИНА	жр
ВЛАСТИЛИНА	жр
ВЛАСТИМИЛ	мр
ВЛАСТИМИР	мр
ВЛАСТИСЛАВ	мр
ВЛАСТИСЛАВА	жр
ВЛАЦЛАВ	мр
ВЛЕВОЛОД	мр
ВЛЕНТИН	мр
ВЛОДИМИР	мр
ВЛПДИМИР	мр
ВОАЛИМИР	мр
ВОВА	мр
ВОВИК	мр
ВОВКА	мр
ВОВОЧКА	мр
ВОДИМ	мр
ВОДИСЛАВ	мр
ВОЗГЕН	мр
ВОЗИР	мр
ВОИСЛАВ	мр
ВОЙТЕХ	мр
ВОЙТКО	мр
ВОЙТЫК	мр
ВОЙЦЕХ	мр
ВОЙЦИК	мр
ВОЙЦИХ	мр
ВОЙЧЕХ	мр
ВОКТОР	мр
ВОЛАДИМИР	мр
ВОЛАДИСЛАВ	мр
ВОЛДЕМАР	мр
ВОЛДИС	мр
ВОЛЕНТИН	мр
ВОЛЕСЛАВ	мр
ВОЛИЙ	мр
ВОЛОДАР	мр
ВОЛОДАРИЙ	мр
ВОЛОДЕЧКА	мр
ВОЛОДИЙ	мр
ВОЛОДИМИР	мр
ВОЛОДЬКА	мр
ВОЛОДЯ	мр
ВОЛТЕР	мр
ВОЛФГАНГ	мр
ВОЛЬДЕМАР	мр
ВОЛЬДЕМАРАС	мр
ВОЛЬДЕМИР	мр
ВОЛЬДИМАР	мр
ВОЛЬМИР	мр
ВОЛЬФ	мр
ВОЛЬФГАНГ	мр
ВОЛЬФГАНТ	мр
ВОНИФАТИЙ	мр
ВОСТАНИК	мр
ВОЦЛАВ	мр
ВРАМ	мр
ВРЕЖИК	мр
ВСЕВОЛОД	мр
ВСЕСЛАВ	мр
ВУГОР	мр
ВУКОЛ	мр
ВУКОСАВА	жр
ВУЛЬФ	мр
ВУСАЛА	жр
ВУСТЯ	жр
ВЧЕСЛАВ	мр
ВЯГИЗ	мр
ВЯЗИР	мр
ВЯКИЛ	мр
ВЯЛИЙ	мр
ВЯЛИМА	жр
ВЯТЕСЛАВ	мр
ВЯТИСЛАВ	мр
ВЯТЧЕСЛАВ	мр
ВЯЧЕЛАВ	мр
ВЯЧЕСВАЛ	мр
ВЯЧЕСЛАВ	мр
ВЯЧЕСЛАВА	жр
ВЯЧЕСЛАВАС	мр
ВЯЧИСЛАВ	мр
ВЯЧУСЛАВ	мр
ГАБАР	мр
ГАБДЕЛБАР	мр
ГАБДЕЛЬБАР	мр
ГАБДЕЛЬЖАБАР	мр
ГАБДЕЛЬХАЙ	мр
ГАБДИНУР	мр
ГАБДРАУФ	мр
ГАБДРАФИК	мр
ГАБДРАШИТ	мр
ГАБДУЛАХАЙ	мр
ГАБДУЛАХАТ	мр
ГАБДУЛБАР	мр
ГАБДУЛВАХИД	мр
ГАБДУЛВАХИТ	мр
ГАБДУЛКАРИМ	мр
ГАБДУЛЛА	мр
ГАБДУЛЛЬ	мр
ГАБДУЛХАК	мр
ГАБИ	жр
ГАБИБ	мр
ГАБИБА	жр
ГАБИБАТ	мр
ГАБИБУЛА	мр
ГАБИБУЛАХ	мр
ГАБИБУЛЛА	мр
ГАБИБУЛЛАХ	мр
ГАБИД	мр
ГАБИДА	жр
ГАБИДАТ	мр
ГАБИДЕН	мр
ГАБИДУЛЛА	мр
ГАБИЛ	мр
ГАБИЛЬ	мр
ГАБИР	мр
ГАБИТ	мр
ГАБИТЬЯН	мр
ГАБИЯ	жр
ГАБОР	мр
ГАБРИЕЛ	мр
ГАБРИЕЛА	жр
ГАБРИЕЛЛА	жр
ГАБРИЕЛЯ	жр
ГАБРИЛ	мр
ГАБРИЭЛА	жр
ГАБРИЭЛЛА	жр
ГАБРИЭЛЬ	мр
ГАВРИИЛ	мр
ГАВРИИЛА	мр
ГАВРИЛ	мр
ГАВРИЛА	мр
ГАВРИЛО	мр
ГАВРИЭЛА	жр
ГАВРИЭЛЛА	жр
ГАВРИЭЛЬ	жр
ГАВРУШ	мр
ГАГАЙ	мр
ГАГАК	мр
ГАГАН	мр
ГАГИК	мр
ГАДАНИЯ	жр
ГАДЕЙ	мр
ГАДЖИ	мр
ГАДЖИ-АГА	мр
ГАДЖИ-ИБРАГИМ	мр
ГАДЖИ-КУРБАН	мр
ГАДЖИ-МАГОМЕД	мр
ГАДЖИАХМЕД	мр
ГАДЖИБЕК	мр
ГАДЖИК	мр
ГАДЖИКАДЫР	мр
ГАДЖИКАИБ	мр
ГАДЖИКАРИМ	мр
ГАДЖИКЕРИМ	мр
ГАДЖИКУРБАН	мр
ГАДЖИМАГАМЕД	мр
ГАДЖИМАГОМЕД	мр
ГАДЖИМЕТ	мр
ГАДЖИМУРАД	мр
ГАДЖИМУРАТ	мр
ГАДЖИРАМАЗАН	мр
ГАДИЙ	мр
ГАДИЛЯ	жр
ГАДИМ	мр
ГАДИС	мр
ГАЗИЗ	мр
ГАЗИЗА	жр
ГАЗИЙ	мр
ГАЗИМ	мр
ГАЗИМАГОМЕД	мр
ГАЗИС	мр
ГАИК	мр
ГАЙ	мр
ГАЙДАРБЕК	мр
ГАЙИПНАЗАР	мр
ГАЙНИТДИН	мр
ГАЙНИЯ	жр
ГАЙНУЛЛА	мр
ГАЙНУТДИН	мр
ГАЙС	мр
ГАЙФУТДИН	мр
ГАКИФА	жр
ГАЛА	жр
ГАЛАК	мр
ГАЛАКТИОН	мр
ГАЛАНА	жр
ГАЛАНДАР	мр
ГАЛАТЕЯ	жр
ГАЛЕЙ	мр
ГАЛЕНТИН	мр
ГАЛЕНТИНА	жр
ГАЛЕРИЙ	мр
ГАЛЕРИНА	жр
ГАЛЕРИЯ	жр
ГАЛЕЯ	жр
ГАЛИ	мр
ГАЛИАН	мр
ГАЛИАНА	жр
ГАЛИАСКАР	мр
ГАЛИБА	жр
ГАЛИЛЯ	жр
ГАЛИМ	мр
ГАЛИМА	жр
ГАЛИМДЖАН	мр
ГАЛИМЖАН	мр
ГАЛИМУЛЛИН	мр
ГАЛИМХАН	мр
ГАЛИНА	жр
ГАЛИНКА	жр
ГАЛИНТИНА	жр
ГАЛИНЯ	жр
ГАЛИП	мр
ГАЛИСИМА	жр
ГАЛИУЛ	мр
ГАЛИЯ	жр
ГАЛЛИЛЕЙ	мр
ГАЛЛИОН	мр
ГАЛЛИЯ	жр
ГАЛЛЯМ	мр
ГАЛНИСА	жр
ГАЛОНА	жр
ГАЛСАН	мр
ГАЛСИРА	жр
ГАЛФАНИЯ	жр
ГАЛФИРА	жр
ГАЛЫМ	мр
ГАЛЫМЖАН	мр
ГАЛЬБИКА	жр
ГАЛЬВИНА	жр
ГАЛЬЗИФА	жр
ГАЛЬМИРА	жр
ГАЛЬМИЯ	жр
ГАЛЬНАРА	жр
ГАЛЬНИСА	жр
ГАЛЬНУРА	жр
ГАЛЬСАРА	жр
ГАЛЬСИМА	жр
ГАЛЬСИНА	жр
ГАЛЬСИНИЯ	жр
ГАЛЬСИНЯ	жр
ГАЛЬСИЯ	жр
ГАЛЬФИНЯ	жр
ГАЛЬЧИРА	жр
ГАЛЮСЯ	жр
ГАЛЯ	жр
ГАЛЯМ	мр
ГАЛЯУТДИН	мр
ГАМАРА	жр
ГАМБАР	мр
ГАМБАРИЯ	жр
ГАМЗАТ	мр
ГАМИД	мр
ГАМИДА	жр
ГАМИДАГА	мр
ГАМИЗ	мр
ГАМИЛ	мр
ГАМИЛА	жр
ГАМИЛЬ	мр
ГАМИЛЯ	жр
ГАМИНА	жр
ГАМИР	мр
ГАМИРА	жр
ГАМИТ	мр
ГАМЛЕТ	мр
ГАНАНИЯ	жр
ГАНЕЛЯ	жр
ГАНЕФА	жр
ГАНИБАЛ	мр
ГАНИБЕК	мр
ГАНИДЖОН	мр
ГАНИЙ	мр
ГАНИНА	жр
ГАНИС	мр
ГАНИФА	мр
ГАНИЯ	жр
ГАННА	жр
ГАННИБАЛ	мр
ГАНРИЭТА	жр
ГАНС	мр
ГАНС-ЮРГЕН	мр
ГАНЯ	жр
ГАОЛИНА	жр
ГАПАН	мр
ГАПИЯ	жр
ГАПКА	жр
ГАППАР	мр
ГАПУР	мр
ГАРАЙ	мр
ГАРАЛЬД	мр
ГАРАН	мр
ГАРАФЕЙ	мр
ГАРАФИЙ	мр
ГАРАФИЛ	мр
ГАРАФУДИН	мр
ГАРАФУТДИН	мр
ГАРГОНИЯ	жр
ГАРЕГЕН	мр
ГАРЕГИЙ	мр
ГАРЕГИН	мр
ГАРЕЙ	мр
ГАРЕКИН	мр
ГАРЕТА	жр
ГАРИ	мр
ГАРИЙ	мр
ГАРИК	мр
ГАРИП	мр
ГАРИСЛАВ	мр
ГАРИТА	жр
ГАРИФ	мр
ГАРИФА	жр
ГАРМАЖАП	мр
ГАРНИК	мр
ГАРНУК	мр
ГАРОЛЬД	мр
ГАРПИНА	жр
ГАРРИ	мр
ГАРРИЙ	мр
ГАРРИС	мр
ГАРРИСЛАВ	мр
ГАРРИСОН	мр
ГАРСИА	мр
ГАРСИЯ	мр
ГАРТЕНЗИЯ	жр
ГАРУН	мр
ГАРУШ	жр
ГАРЯГДЫ	мр
ГАРЯЙ	мр
ГАСАН	мр
ГАСИЯ	жр
ГАСКИРА	жр
ГАСПАР	мр
ГАСРАТ	мр
ГАТАП	мр
ГАТАУЛ	мр
ГАТУФ	мр
ГАУГАР	мр
ГАУХАР	жр
ГАУХАРИЯ	жр
ГАФАР	мр
ГАФИРА	жр
ГАФИРЯ	жр
ГАФИФА	жр
ГАФИЯ	жр
ГАФУР	мр
ГАФУРЖАН	мр
ГАФФА	жр
ГАФФАР	мр
ГАФЬЯ	жр
ГАЯЗ	мр
ГАЯЗЕТДИН	мр
ГАЯЗУТДИН	мр
ГАЯНА	жр
ГАЯНЕ	жр
ГАЯННА	жр
ГАЯНЭ	жр
ГАЯР	мр
ГВИДО	мр
ГВИДОН	мр
ГДАЛИЙ	мр
ГДАЛЯ	жр
ГЕБХАРД	мр
ГЕВАРТ	мр
ГЕВЕН	мр
ГЕВОНД	мр
ГЕВОРГ	мр
ГЕВОРГИЗ	мр
ГЕВОРИК	мр
ГЕВОРК	мр
ГЕВОРТ	мр
ГЕВОРХ	мр
ГЕДАЛИЙ	мр
ГЕДАЛЬЯ	жр
ГЕДВИГА	жр
ГЕДЕВАН	мр
ГЕДЕВОН	мр
ГЕДЕМИНАС	мр
ГЕДЕОН	мр
ГЕДИМИНАС	мр
ГЕДИОН	мр
ГЕДМИНАС	мр
ГЕДРЮС	мр
ГЕЗА	мр
ГЕЙБАДУЛА	жр
ГЕЙБАДУЛЬ	мр
ГЕЙДАР	мр
ГЕЙДАРОВ	мр
ГЕЙЗА	мр
ГЕЙМУРАЗ	мр
ГЕЙНИХ	мр
ГЕЙНРИХ	мр
ГЕЙРАН	мр
ГЕЙРАТ	мр
ГЕЙС	мр
ГЕЙЯ	жр
ГЕК	мр
ГЕКТОР	мр
ГЕКХАН	мр
ГЕКЧЕК	мр
ГЕЛАНА	жр
ГЕЛАРИЙ	мр
ГЕЛГЕНА	жр
ГЕЛЕНА	жр
ГЕЛЕРИЯ	жр
ГЕЛИАНА	жр
ГЕЛИАННА	жр
ГЕЛИАНТА	жр
ГЕЛИАРД	мр
ГЕЛИЙ	мр
ГЕЛИОНА	жр
ГЕЛИОС	мр
ГЕЛИРА	жр
ГЕЛИСА	жр
ГЕЛИТА	жр
ГЕЛИЯ	жр
ГЕЛЛА	жр
ГЕЛЛАРИЙ	мр
ГЕЛОНА	жр
ГЕЛСИРЯ	жр
ГЕЛСИЯ	жр
ГЕЛФИЯ	жр
ГЕЛЬБЕРТ	мр
ГЕЛЬВИНА	жр
ГЕЛЬГА	жр
ГЕЛЬГЕНЯ	жр
ГЕЛЬГИНА	жр
ГЕЛЬДЫ	мр
ГЕЛЬДЫМУРАД	мр
ГЕЛЬЗАРА	жр
ГЕЛЬЗИФА	жр
ГЕЛЬМА	жр
ГЕЛЬМЕТДИН	мр
ГЕЛЬМИНА	жр
ГЕЛЬМИРА	жр
ГЕЛЬМУТ	мр
ГЕЛЬНАРА	жр
ГЕЛЬНУРА	жр
ГЕЛЬНЮРА	жр
ГЕЛЬСАРИЯ	жр
ГЕЛЬСИНА	жр
ГЕЛЬСИНЯ	жр
ГЕЛЬСИРА	жр
ГЕЛЬСИРИЯ	жр
ГЕЛЬСИРЯ	жр
ГЕЛЬСИЯ	жр
ГЕЛЬТРУДА	жр
ГЕЛЬФАНИЯ	жр
ГЕЛЬФИРИЯ	жр
ГЕЛЬФИЯ	жр
ГЕЛЮСЯ	жр
ГЕНА	мр
ГЕНАДИЙ	мр
ГЕНАЕФА	жр
ГЕНАИДА	жр
ГЕНАНАДИЙ	мр
ГЕНАНДИЙ	мр
ГЕНГРИЕТА	жр
ГЕНДРИК	мр
ГЕНДРИХ	мр
ГЕНЕРА	жр
ГЕНЕСА	жр
ГЕНЕФА	жр
ГЕНЖЕБАЙ	мр
ГЕНКА	мр
ГЕННАДИЙ	мр
ГЕННАДИЯ	жр
ГЕННАИДА	жр
ГЕННАЛИЙ	мр
ГЕННЕДИЙ	мр
ГЕННИЙ	мр
ГЕНОВЕРА	жр
ГЕНОВЕФА	жр
ГЕНОЕФА	жр
ГЕНОФЕРА	жр
ГЕНОФЕФА	жр
ГЕНОЭФА	жр
ГЕНРИ	мр
ГЕНРИДА	жр
ГЕНРИЕТТ	жр
ГЕНРИЕТТА	жр
ГЕНРИК	мр
ГЕНРИКА	жр
ГЕНРИСТА	жр
ГЕНРИТА	жр
ГЕНРИТТА	жр
ГЕНРИХ	мр
ГЕНРИЭТА	жр
ГЕНРИЭТТА	жр
ГЕНУЭФА	жр
ГЕНЯ	мр
ГЕОГИЙ	мр
ГЕОГИНА	жр
ГЕОНЕФА	жр
ГЕОРГ	мр
ГЕОРГЕ	мр
ГЕОРГЕС	мр
ГЕОРГИ	мр
ГЕОРГИАДИС	мр
ГЕОРГИЙ	мр
ГЕОРГИНИЯ	жр
ГЕОРГИОС	мр
ГЕОРГИС	мр
ГЕОРГИЦ	мр
ГЕОРГИЯ	жр
ГЕОРИЙ	мр
ГЕРА	жр
ГЕРАДИЙ	мр
ГЕРАИДА	жр
ГЕРАИНА	жр
ГЕРАИСА	жр
ГЕРАЙДА	жр
ГЕРАКЛ	мр
ГЕРАКЛИТ	мр
ГЕРАЛЬД	мр
ГЕРАЛЬДА	жр
ГЕРАЛЬДИНА	жр
ГЕРАНТИЙ	мр
ГЕРАРД	мр
ГЕРАСИЙ	мр
ГЕРАСИМ	мр
ГЕРАСИМОС	мр
ГЕРБЕРТ	мр
ГЕРВАСИЙ	мр
ГЕРГАНА	жр
ГЕРГАРД	мр
ГЕРГИЙ	мр
ГЕРГИНА	жр
ГЕРД	мр
ГЕРДА	жр
ГЕРЕЙХАН	мр
ГЕРЕК	мр
ГЕРИЙ	мр
ГЕРИК	мр
ГЕРИКНАЗ	мр
ГЕРИНА	жр
ГЕРИХ	мр
ГЕРЛИНА	жр
ГЕРМАГЕН	мр
ГЕРМАН	мр
ГЕРМАНА	жр
ГЕРМАНН	мр
ГЕРМАНС	мр
ГЕРМЕС	мр
ГЕРМИН	мр
ГЕРМИНА	жр
ГЕРМИОНА	жр
ГЕРМОГЕН	мр
ГЕРМОГЕНТ	мр
ГЕРНОЛЬД	мр
ГЕРОГИЙ	мр
ГЕРОИД	мр
ГЕРОИДА	жр
ГЕРОЛЬД	мр
ГЕРОН	мр
ГЕРОНИЙ	мр
ГЕРОНИМ	мр
ГЕРОНТИЙ	мр
ГЕРРАДИЙ	мр
ГЕРРГИЙ	мр
ГЕРСЕЛИЯ	жр
ГЕРТ	мр
ГЕРТА	жр
ГЕРТРУДА	жр
ГЕРФАН	мр
ГЕРХАРД	мр
ГЕРШ	мр
ГЕРШИН	мр
ГЕРШК	мр
ГЕРШКО	мр
ГЕРШОН	мр
ГЕСЯ	жр
ГЕТАЛИНА	жр
ГЕТАЛЬМИНА	жр
ГЕТРУДА	жр
ГЕТТА	жр
ГЕЯ	жр
ГИА	мр
ГИБАДУЛЛ	мр
ГИВАРГИЗ	мр
ГИВИ	мр
ГИВОРГ	мр
ГИГОР	мр
ГИГОРИЙ	мр
ГИГРАН	мр
ГИДАЛИЙ	мр
ГИДЖРАН	мр
ГИДОН	мр
ГИЗАР	мр
ГИЗЕЛА	жр
ГИЗЕЛЛА	жр
ГИЗЕЛЯ	жр
ГИКМЕТ	мр
ГИКОЛАЙ	мр
ГИЛАЛ	мр
ГИЛАНА	жр
ГИЛАНИЙ	мр
ГИЛАРИЙ	мр
ГИЛИМХАН	мр
ГИЛЬДА	жр
ГИЛЬДЕБЕРТ	мр
ГИЛЬДЕГАРД	мр
ГИЛЬМАТДИН	мр
ГИЛЬМЕТДИН	мр
ГИЛЬМИЗИЯ	жр
ГИЛЬМИНИСА	жр
ГИЛЬМУЛЛА	мр
ГИЛЬМУТДИН	мр
ГИЛЬНАРА	жр
ГИЛЬСАРИЯ	жр
ГИЛЬСИМА	жр
ГИЛЬСИНА	жр
ГИЛЬСИНЯ	жр
ГИЛЬСИРА	жр
ГИЛЬФАН	мр
ГИЛЬФИРЯ	жр
ГИЛЯРИЙ	мр
ГИМАЛЬДИН	мр
ГИМАТ	мр
ГИМБАТ	мр
ГИМРАН	мр
ГИНАДИЙ	мр
ГИНАИДА	жр
ГИНЕССА	жр
ГИНИЯТ	мр
ГИННЕС	мр
ГИНТАРАС	мр
ГИНТАРИС	мр
ГИОРГИ	мр
ГИППОЛИТ	мр
ГИРФАН	мр
ГИРШ	мр
ГИТА	жр
ГИЯ	мр
ГИЯЗ	мр
ГИЯМ	мр
ГИЯС	мр
ГЛАКЕРИЯ	жр
ГЛАРА	жр
ГЛАФИНА	жр
ГЛАФИРА	жр
ГЛАФИРИЯ	жр
ГЛАША	жр
ГЛЕБ	мр
ГЛЕБКА	мр
ГЛЕКЕРИЯ	жр
ГЛЕН	мр
ГЛЕНА	жр
ГЛИКЕРИЯ	жр
ГЛИКЕРЬЯ	жр
ГЛИРА	жр
ГЛОРИАНА	жр
ГЛОРИЙ	мр
ГЛОФИРА	жр
ГЛУКЕРИЯ	жр
ГНАТ	мр
ГНЕЛ	мр
ГОАР	мр
ГОАРИК	мр
ГОБИЯ	жр
ГОВАРД	мр
ГОВИК	мр
ГОВХЕР	мр
ГОГАР	мр
ГОГАРИК	мр
ГОГИ	мр
ГОДЕЛЬ	жр
ГОЛАМ	мр
ГОЛАН	мр
ГОЛЬДА	жр
ГОЛЬФИНЯ	жр
ГОНОРИЙ	мр
ГОНСАЛЕС	мр
ГОР	мр
ГОРАЛЬД	мр
ГОРАН	мр
ГОРАЦИЙ	мр
ГОРГИЙ	мр
ГОРДАНА	жр
ГОРДЕЙ	мр
ГОРДИЙ	мр
ГОРДОН	мр
ГОРИЙ	мр
ГОРИК	мр
ГОРИМИР	мр
ГОРИНА	жр
ГОРИСЛАВ	мр
ГОРИСЛАВА	жр
ГОРИЯ	жр
ГОРОЛЬД	мр
ГОРПИНА	жр
ГОРПЫНА	жр
ГОТЛИБ	мр
ГОТЛИП	мр
ГОТФРИД	мр
ГОФАР	мр
ГОФИК	мр
ГОЧА	мр
ГОША	мр
ГОЯР	мр
ГОЯРИК	мр
ГРАДИСЛАВ	мр
ГРАДИСЛАВА	жр
ГРАЖИНА	жр
ГРАНИДА	жр
ГРАНИСЛАВ	мр
ГРАНИСЛАВА	жр
ГРАНИТА	жр
ГРАФИДА	жр
ГРАФИНА	жр
ГРАФИРА	жр
ГРАЦИЭЛЛА	жр
ГРАЧИК	мр
ГРЕГОР	мр
ГРЕГОРИ	мр
ГРЕГОРИЙ	мр
ГРЕЙС	жр
ГРЕЙТА	жр
ГРЕТА	жр
ГРЕТЕЛЬ	жр
ГРЕТТА	жр
ГРИГООРИЙ	мр
ГРИГОР	мр
ГРИГОРИЙ	мр
ГРИГОРИН	мр
ГРИГОРИНА	жр
ГРИГОРИЯ	жр
ГРИГОРТИЙ	мр
ГРИГРИЙ	мр
ГРИГШОРИЙ	мр
ГРИЖИНА	жр
ГРИЗЕЛЬДА	жр
ГРИНАДА	жр
ГРИНЬКА	мр
ГРИТА	жр
ГРИТТА	жр
ГРИЦЬКО	мр
ГРИША	мр
ГРЭЙС	жр
ГРЭМ	мр
ГРЭТА	жр
ГУБАЙДУЛЛА	мр
ГУГ	мр
ГУГОН	мр
ГУДРАТ	мр
ГУДРЕТДИН	мр
ГУЗАЛЬ	жр
ГУЗАЛЬЯ	жр
ГУЗЕЛИЯ	жр
ГУЗЕЛЬ	жр
ГУЗЭЛИЯ	жр
ГУЗЯЛИЯ	жр
ГУЗЯЛЬ	жр
ГУЙНАРА	жр
ГУЛАИМ	жр
ГУЛАМ	мр
ГУЛАМДЖАН	мр
ГУЛАМЖАН	мр
ГУЛАМЖОН	мр
ГУЛАМИДИН	мр
ГУЛИВЕР	мр
ГУЛИЗАР	жр
ГУЛИЗАРА	жр
ГУЛИМБАЙ	мр
ГУЛИЯ	мр
ГУЛЛИВЕР	мр
ГУЛОМ	мр
ГУЛОМАЛИ	мр
ГУЛЬАРА	жр
ГУЛЬДАНА	жр
ГУЛЬДЖАМИЛЯ	жр
ГУЛЬЖИАН	жр
ГУЛЬЖИГАН	жр
ГУЛЬЖИХАН	мр
ГУЛЬЖИЯ	жр
ГУЛЬЖИЯН	жр
ГУЛЬЗАР	жр
ГУЛЬЗИГАН	мр
ГУЛЬКАЙ	жр
ГУЛЬМАН	мр
ГУЛЬМИНА	жр
ГУЛЬМИНИКА	жр
ГУЛЬМИРА	жр
ГУЛЬНАЗИРА	жр
ГУЛЬНАРА	жр
ГУЛЬНУР	жр
ГУЛЬНУРА	жр
ГУЛЬНУРИЯ	жр
ГУЛЬСЕМ	мр
ГУЛЬТАН	мр
ГУЛЬФИЗА	жр
ГУЛЬФИЗЯ	жр
ГУЛЬФИРА	жр
ГУЛЬФИРЯ	жр
ГУЛЬФИЯ	жр
ГУЛЬЧАЧАК	мр
ГУЛЬЧЕЧЕК	мр
ГУЛЬЧИГАН	мр
ГУЛЬЧОХРА	жр
ГУЛЬШАН	жр
ГУЛЬШАТ	жр
ГУЛЯ	жр
ГУМЕР	мр
ГУМИР	мр
ГУНАЛА	жр
ГУНДА	жр
ГУНДЕГА	жр
ГУНЕЛЬ	жр
ГУНЕФА	жр
ГУННАР	мр
ГУНТИС	мр
ГУРАМ	мр
ГУРАМИ	мр
ГУРАТ	мр
ГУРГЕН	мр
ГУРЕЙ	мр
ГУРЕН	мр
ГУРЕШ	мр
ГУРИЙ	мр
ГУСЕЙН	мр
ГУСЕЙНГУЛУ	мр
ГУСЕЙХАН	мр
ГУСТАВ	мр
ГУСТАВА	жр
ГУСТАВО	мр
ГЭРИ	мр
ГЮЗАЛИЯ	жр
ГЮЗЕЛ	жр
ГЮЗЕЛАГА	мр
ГЮЗЕЛИЯ	жр
ГЮЗЕЛЬ	жр
ГЮЗЭЛЬ	жр
ГЮЗЯЛЬ	жр
ГЮЛАДДИН	мр
ГЮЛАЙ	мр
ГЮЛНАРА	жр
ГЮЛХАР	мр
ГЮЛЬАДДИН	мр
ГЮЛЬАХМЕД	мр
ГЮЛЬБАГАР	мр
ГЮЛЬВАРД	мр
ГЮЛЬВАРТ	мр
ГЮЛЬГУСЕЙН	мр
ГЮЛЬДАРАН	мр
ГЮЛЬДЖАХАН	мр
ГЮЛЬДЖИГАН	мр
ГЮЛЬЖАГАН	мр
ГЮЛЬЗАМАН	мр
ГЮЛЬМАГОМЕД	мр
ГЮЛЬМАМЕД	мр
ГЮЛЬНАР	мр
ГЮЛЬНАРА	жр
ГЮЛЬХАРА	жр
ГЮЛЬЧАРА	жр
ГЮЛЬЧИТАЙ	жр
ГЮЛЬЧОХРА	жр
ГЮНАЙ	жр
ГЮНТЕР	мр
ДАВЕЙ	мр
ДАВИД	мр
ДАВИДА	жр
ДАВИДБЕК	мр
ДАВИЛА	жр
ДАВИЯ	жр
ДАВЛАД	мр
ДАВЛАТ	мр
ДАВЛАТБАЙ	мр
ДАВЛАТЖОН	мр
ДАВЛАТКАДАМ	мр
ДАВЛАТМИР	мр
ДАВЛЕТ	мр
ДАВЛЕТБАЙ	мр
ДАВЛЕТМУРАД	мр
ДАВРАН	мр
ДАВРАНБЕК	мр
ДАВРОН	мр
ДАВРОНБАЙ	мр
ДАВРОНБЕК	мр
ДАВРОНЧОН	мр
ДАВУД	мр
ДАВЫД	мр
ДАГАН	мр
ДАГИСТАН	мр
ДАГИТ	мр
ДАГИЯ	жр
ДАГЛАР	мр
ДАГМАР	жр
ДАГМАРА	жр
ДАГНИЯ	жр
ДАГОБЕРТ	мр
ДАДА	жр
ДАДАШБАЙ	мр
ДАДАШБАЛА	мр
ДАЖДАМИР	мр
ДАЗМИРА	жр
ДАИМА	жр
ДАИНА	жр
ДАИРБЕК	мр
ДАИСА	жр
ДАЙАНА	жр
ДАЙВА	жр
ДАЙГА	жр
ДАЙНИС	мр
ДАКАР	мр
ДАЛАЙ	мр
ДАЛЕР	мр
ДАЛИДА	жр
ДАЛИЙ	мр
ДАЛИЛА	жр
ДАЛИНИЯ	жр
ДАЛИРА	жр
ДАЛЬВА	жр
ДАЛЬВИНА	жр
ДАЛЬМИРА	жр
ДАЛЬФИНА	жр
ДАЛЬЯ	жр
ДАЛЯЛЬ	жр
ДАЛЯНА	жр
ДАМАРА	жр
ДАМЕД	мр
ДАМЕЛЯ	жр
ДАМЕТ	мр
ДАМИАН	мр
ДАМИЛЯ	жр
ДАМИР	мр
ДАМИРА	жр
ДАН	мр
ДАНА	жр
ДАНАИДА	жр
ДАНАРА	жр
ДАНАТ	мр
ДАНАТА	жр
ДАНАТАР	мр
ДАНАТОР	мр
ДАНАЯ	жр
ДАНГ	мр
ДАНЕЛЯ	жр
ДАНЕТА	жр
ДАНЗАН	мр
ДАНИДА	жр
ДАНИЕЛ	мр
ДАНИЕЛА	жр
ДАНИЕЛЛА	жр
ДАНИЕЛЬ	мр
ДАНИЕР	мр
ДАНИИЛ	мр
ДАНИИЛА	жр
ДАНИЙ	мр
ДАНИКА	жр
ДАНИЛ	мр
ДАНИЛА	мр
ДАНИЛБЕК	мр
ДАНИЛИЯ	жр
ДАНИЛЛ	мр
ДАНИЛЛА	жр
ДАНИЛО	мр
ДАНИЛЬ	мр
ДАНИЛЯ	жр
ДАНИНА	жр
ДАНИРА	жр
ДАНИРЯ	жр
ДАНИСА	жр
ДАНИСЛАВА	жр
ДАНИСЯ	жр
ДАНИТА	жр
ДАНИЭЛ	мр
ДАНИЭЛА	жр
ДАНИЭЛИЯ	жр
ДАНИЭЛЛА	жр
ДАНИЭЛЬ	мр
ДАНИЯЛ	мр
ДАНИЯН	мр
ДАНИЯР	мр
ДАНКА	жр
ДАНКО	мр
ДАННА	жр
ДАНТЕ	мр-жр
ДАНУСЯ	жр
ДАНУТА	жр
ДАНУТЕ	жр
ДАНЬЯ	жр
ДАНЯ	мр
ДАРИАН	мр
ДАРИАННА	жр
ДАРИДА	жр
ДАРИДЖАНА	жр
ДАРИЙ	мр
ДАРИНА	жр
ДАРИСА	жр
ДАРИТА	жр
ДАРИЯ	жр
ДАРРЕН	мр
ДАРТАНЬЯН	мр
ДАРШАН	мр
ДАРЬЯ	жр
ДАРЬЯНА	жр
ДАСИЙ	мр
ДАСИМ	мр
ДАСИЯ	жр
ДАСЯ	жр
ДАТИКО	мр
ДАТУНА	жр
ДАТУША	мр
ДАУД	мр
ДАУДА	жр
ДАУЛЕТ	мр
ДАУЛЕТКАЛИЙ	мр
ДАУЛЕТКАН	мр
ДАУР	мр
ДАУРБЕК	мр
ДАУТ	мр
ДАФАЛЛА	жр
ДАФИНА	жр
ДАФНИС	мр
ДАХИЯ	жр
ДАЦЕ	жр
ДАША	жр
ДАШЕНЬКА	жр
ДАШИПЫЛ	мр
ДАЯ	жр
ДАЯН	мр
ДАЯНА	жр
ДВЕЙРА	жр
ДВОЙРА	мр
ДВОСЯ	жр
ДЕАЛИНА	жр
ДЕАННА	жр
ДЕБОРА	жр
ДЕБРА	жр
ДЕВЕНДРА	жр
ДЕВИД	мр
ДЕВЛЕТ	мр
ДЕВОРА	жр
ДЕВРОНИЯ	жр
ДЕДАЛ	мр
ДЕЗДЕМОНА	жр
ДЕЗИДЕРИЙ	мр
ДЕЙВИД	мр
ДЕЙВИС	мр
ДЕЙЛИН	мр
ДЕКАБРИНА	жр
ДЕЛЕРА	жр
ДЕЛИЙ	мр
ДЕЛИНА	жр
ДЕЛОРА	жр
ДЕЛЬБАРА	жр
ДЕЛЬДОРА	жр
ДЕЛЬФИНА	жр
ДЕЛЯРА	жр
ДЕМА	мр
ДЕМЕД	мр
ДЕМЕНТИЙ	мр
ДЕМЕТЕР	мр
ДЕМИД	мр
ДЕМИР	мр
ДЕМИРА	жр
ДЕМИС	мр
ДЕМИТРИЙ	мр
ДЕМНА	жр
ДЕМОКРИТ	мр
ДЕМУР	мр
ДЕМУРА	жр
ДЕМЬЯН	мр
ДЕМЯН	мр
ДЕН	мр
ДЕНАИДА	жр
ДЕНГИЗ	мр
ДЕНИ	мр
ДЕНИЗ	мр
ДЕНИЗА	жр
ДЕНИС	мр
ДЕНИСИЙ	мр
ДЕНИСИЯ	жр
ДЕНИСК	мр
ДЕНИСЛАВ	мр
ДЕНИСЛАМ	мр
ДЕНИЯ	жр
ДЕННИ	мр
ДЕННИС	мр
ДЕОНИД	мр
ДЕОНИДА	жр
ДЕОНИЗ	мр
ДЕОНИЗА	жр
ДЕОНИЗИЙ	мр
ДЕОНИЗИЯ	жр
ДЕОНИС	мр
ДЕОНИСИЙ	мр
ДЕРЕК	мр
ДЕРЕНИК	мр
ДЕРК	мр
ДЕСАНКА	жр
ДЕСИСЛАВА	жр
ДЕСМОНД	мр
ДЕСНИНА	жр
ДЕСПИНА	жр
ДЕСПИНИЯ	жр
ДЕХКАН	мр
ДЕХТЯР	мр
ДЕЧЕБАЛ	мр
ДЕЧКО	мр
ДЕЯ	жр
ДЖАБАР	мр
ДЖАББАР	мр
ДЖАББОР	мр
ДЖАБЕР	мр
ДЖАБИР	мр
ДЖАБРАИЛ	мр
ДЖАВАД	мр
ДЖАВАНШИР	мр
ДЖАВГАР	мр
ДЖАВДАТ	мр
ДЖАВДЕТ	мр
ДЖАВЕД	мр
ДЖАВИД	мр
ДЖАВИДА	жр
ДЖАГАФАР	мр
ДЖАИД	мр
ДЖАИНА	жр
ДЖАЙДИП	мр
ДЖАКОБ	мр
ДЖАКОМО	мр
ДЖАЛАЛ	мр
ДЖАЛАЛАДДИН	мр
ДЖАЛАЛУТДИН	мр
ДЖАЛЕЛ	мр
ДЖАЛИЛ	мр
ДЖАЛИЛЬ	мр
ДЖАЛИЛЯ	жр
ДЖАЛИНА	жр
ДЖАЛИТА	жр
ДЖАЛОЛИДИН	мр
ДЖАЛЯЛ	мр
ДЖАМАВ	мр
ДЖАМАДИН	мр
ДЖАМАЛ	мр
ДЖАМАЛАДДИН	мр
ДЖАМАЛДДИН	мр
ДЖАМАЛДИН	мр
ДЖАМАЛЕДДИН	мр
ДЖАМАЛЕТДИН	мр
ДЖАМАЛИ	мр
ДЖАМАЛИДДИН	мр
ДЖАМАЛИДИН	мр
ДЖАМАЛУДИН	мр
ДЖАМАЛУТДИН	мр
ДЖАМАЛЬ	мр
ДЖАМБЕК	мр
ДЖАМБУЛИ	мр
ДЖАМЕЛЯ	жр
ДЖАМИД	мр
ДЖАМИДИН	мр
ДЖАМИЛ	мр
ДЖАМИЛА	жр
ДЖАМИЛАТ	мр
ДЖАМИЛИЯ	жр
ДЖАМИЛЬ	мр
ДЖАМИЛЯ	жр
ДЖАМОЛДИН	мр
ДЖАМОЛИДДИН	мр
ДЖАМОЛИДИН	мр
ДЖАМОЛИТДИН	мр
ДЖАМШЕД	мр
ДЖАН	мр
ДЖАНБЕК	мр
ДЖАНГИР	мр
ДЖАНГЮР	мр
ДЖАНЕТА	жр
ДЖАНЕТТА	жр
ДЖАНИБЕК	мр
ДЖАНИК	мр
ДЖАНИТА	жр
ДЖАНЛУКА	жр
ДЖАНН	мр
ДЖАННА	мр
ДЖАННЕТА	жр
ДЖАННЕТТА	жр
ДЖАННИ	мр
ДЖАНЫБЕК	мр
ДЖАПАР	мр
ДЖАППАР	мр
ДЖАСМИНА	жр
ДЖАСТИН	мр
ДЖАСУР	мр
ДЖАФАР	мр
ДЖАФЕР	мр
ДЖАФИР	мр
ДЖАФФАР	мр
ДЖАХАД	мр
ДЖАХАН	мр
ДЖАХАНГИР	мр
ДЖАХАНДАР	мр
ДЖЕВРИЯ	жр
ДЖЕГУТ	мр
ДЖЕЙМС	мр
ДЖЕЙН	жр
ДЖЕЙРА	жр
ДЖЕЙРАХ-ТАРГИМ	мр
ДЖЕЙСОН	мр
ДЖЕК	мр
ДЖЕМА	жр
ДЖЕМАИЛ	мр
ДЖЕМАЛ	мр
ДЖЕМАЛЕТДИН	мр
ДЖЕМАЛЕТТИН	мр
ДЖЕММА	жр
ДЖЕНА	жр
ДЖЕНЕТ-ХАН	мр
ДЖЕНЕТТА	жр
ДЖЕННЕТА	жр
ДЖЕННИФЕР	жр
ДЖЕРАЛЬД	мр
ДЖЕРАРД	мр
ДЖЕРОМ	мр
ДЖЕСИ	жр
ДЖЕСИКА	жр
ДЖЕССИ	жр
ДЖЕССИКА	жр
ДЖЕФФ	мр
ДЖЕФФЕРСОН	мр
ДЖЕФФРИ	мр
ДЖИЛ	жр
ДЖИЛЬДА	жр
ДЖИМ	мр
ДЖИМА	жр
ДЖИММА	мр
ДЖИНА	жр
ДЖИФЕР	мр
ДЖИХАН	мр
ДЖО	мр
ДЖОАН	жр
ДЖОАНА	жр
ДЖОВАННА	жр
ДЖОГАН	мр
ДЖОЗЕФ	мр
ДЖОЗЕФИНА	жр
ДЖОЗЕФСОН	мр
ДЖОН	мр
ДЖОНАТАН	мр
ДЖОНГ	мр
ДЖОНИ	мр
ДЖОНИБЕК	мр
ДЖОНИК	мр
ДЖОНМАМАД	мр
ДЖОНМАХМАД	мр
ДЖОННА	жр
ДЖОННИ	мр
ДЖОНС	мр
ДЖОНСОН	мр
ДЖОРДАНО	мр
ДЖОРДЖ	мр
ДЖОРДЖЕТТА	жр
ДЖОРДЖО	мр
ДЖОРЖЕТА	жр
ДЖОРИЙ	мр
ДЖОХАН	мр
ДЖОХАР	мр
ДЖОШУА	мр
ДЖОЭЛ	мр
ДЖУ	мр
ДЖУАНА	жр
ДЖУАННА	жр
ДЖУБГА	жр
ДЖУЗЕППЕ	мр
ДЖУКАН	мр
ДЖУЛЕТА	жр
ДЖУЛЕТТА	жр
ДЖУЛИАН	мр
ДЖУЛИАНА	жр
ДЖУЛИАНС	жр
ДЖУЛИЕТА	жр
ДЖУЛИСТА	жр
ДЖУЛИЯ	жр
ДЖУЛЛЕТА	жр
ДЖУЛЬЕТТА	жр
ДЖУМАБЕК	мр
ДЖУМАД	мр
ДЖУМАЛЬДИН	мр
ДЖУМБЛАТ	мр
ДЖУНА	жр
ДЖУНАЙД	мр
ДЖУНИТ	мр
ДЖУНЯ	жр
ДЖУРАБЕК	мр
ДЖУРМА	жр
ДЖУТЕЙЛ	мр
ДЖУТЕЙЛЬ	мр
ДЗВЕНИСЛАВА	жр
ДЗЕЗЮЛЬ	жр
ДЗЕРОН	мр
ДЗИВГИС	мр
ДЗИДРА	жр
ДЗИНТРА	жр
ДЗЮНЪИТИРО	мр
ДЗЯУДИН	мр
ДИАМАРА	жр
ДИАНА	жр
ДИАНИДА	жр
ДИАНИНА	жр
ДИАННА	жр
ДИБАХАН	мр
ДИБОРА	жр
ДИВАК	мр
ДИВНА	жр
ДИГРАН	мр
ДИДАЛ	мр
ДИДИНА	жр
ДИДИЯ	жр
ДИДОНА	жр
ДИДРА	жр
ДИДУХ	мр
ДИДЬЕ	мр
ДИЕГО	мр
ДИЕРА	жр
ДИЗЕНДОРФ	мр
ДИК	мр
ДИЛАИДА	жр
ДИЛАН	мр
ДИЛАРА	жр
ДИЛАРАМ	мр
ДИЛМАН	мр
ДИЛОНА	жр
ДИЛОРА	жр
ДИЛШАД	мр
ДИЛЬБАР	жр
ДИЛЬБАРА	жр
ДИЛЬБЕРА	жр
ДИЛЬДОРА	жр
ДИЛЬМАТ	мр
ДИЛЬМУРАД	мр
ДИЛЬМУРАТ	мр
ДИЛЬНАЗА	жр
ДИЛЬНАРА	жр
ДИЛЬНОЗА	жр
ДИЛЬРУБА	жр
ДИЛЬФУЗА	жр
ДИЛЯ	жр
ДИЛЯВЕР	мр
ДИЛЯНА	жр
ДИЛЯР	мр
ДИЛЯРА	жр
ДИЛЯФРУЗ	жр
ДИЛЯФРУЗА	жр
ДИЛЯФРУС	жр
ДИМА	мр
ДИМЕНТИЙ	мр
ДИМИД	мр
ДИМИТРА	жр
ДИМИТРИ	мр
ДИМИТРИЙ	мр
ДИМИТРИНА	жр
ДИМКА	мр
ДИМОЧКА	мр
ДИМЬЯН	мр
ДИН	мр
ДИНА	жр
ДИНАДИЙ	мр
ДИНАИДА	жр
ДИНАРА	жр
ДИНАРИЯ	жр
ДИНИЯ	жр
ДИОГЕН	мр
ДИОМИД	мр
ДИОНИДА	жр
ДИОНИЗА	жр
ДИОНИЗИЙ	мр
ДИОНИЗИЯ	жр
ДИОНИС	мр
ДИОНИСИЙ	мр
ДИОНИСИЯ	жр
ДИОРА	жр
ДИПКУН	мр
ДИР	мр
ДИРАДЖ	мр
ДИРАР	мр
ДИРЕК	мр
ДИРК	мр
ДИСАНА	жр
ДИТЕР	мр
ДИТРИХ	мр
ДИТТЕ	мр
ДИЯ	жр
ДИЯНА	жр
ДИЯР	мр
ДИЯРА	жр
ДМИТИРИЙ	мр
ДМИТР	мр
ДМИТРА	жр
ДМИТРИАН	мр
ДМИТРИЙ	мр
ДМИТРИК	мр
ДМИТРИОС	мр
ДМИТРИС	мр
ДМИТРИЯ	жр
ДМИТРИЯН	мр
ДМИТРО	мр
ДМЫТРО	мр
ДОБРИНА	жр
ДОБРОМИР	мр
ДОБРОСЛАВ	мр
ДОБРОСЛАВА	жр
ДОБРУСЯ	жр
ДОБРУШ	мр
ДОБРУША	жр
ДОБРЫНЯ	мр
ДОВЛАТ	мр
ДОВЛЕТ	мр
ДОВЛЕТБЕРДИ	мр
ДОВЛЕТБИЙ	мр
ДОВЛЕТГЕЛЬДЫ	мр
ДОВЛЕТМУРАД	мр
ДОВЛЕТЯР	мр
ДОГМАРА	жр
ДОКУ	мр
ДОЛАРЕССА	жр
ДОЛАРИСА	жр
ДОЛЕНА	жр
ДОЛЕНИКА	жр
ДОЛЕНИКИЯ	жр
ДОЛИЙ	мр
ДОЛЛОРЕСА	жр
ДОЛОРЕС	жр
ДОМИНИК	мр
ДОМНИКА	жр
ДОМНИКИЯ	жр
ДОН	мр
ДОНАЛД	мр
ДОНАЛЬД	мр
ДОНАРА	жр
ДОНАТ	мр
ДОНАТАС	мр
ДОРА	жр
ДОРАТЕЯ	жр
ДОРЕАНЯ	мр
ДОРИАН	мр
ДОРИАНА	жр
ДОРИАННА	жр
ДОРИДА	жр
ДОРИЙ	мр
ДОРИК	мр
ДОРИКО	жр
ДОРИН	мр
ДОРИНА	жр
ДОРИОН	мр
ДОРИС	жр
ДОРИСА	жр
ДОРИЯ	жр
ДОРМИДОН	мр
ДОРМИДОНТ	мр
ДОРОТА	жр
ДОРОТЕА	жр
ДОРОТЕЯ	жр
ДОРОТИ	жр
ДОРОФЕЙ	мр
ДОРОФЕЯ	жр
ДОРЬЯ	жр
ДОСЖАН	мр
ДОСИФЕЙ	мр
ДРАГОЛЮБ	мр
ДРАГОМИР	мр
ДРАГОМИРА	жр
ДРАГОСЛАВ	мр
ДРАГОСЛАВА	жр
ДРЮ	жр
ДУБРАВКА	жр
ДУБРАВКО	мр
ДУГАР	мр
ДУГАРЖАП	мр
ДУГЛАС	мр
ДУЛЬЦИНЕЯ	жр
ДУН	мр
ДУНЯ	жр
ДУНЯМАЛЫ	мр
ДУНЯША	жр
ДУРМИШХАН	мр
ДУРСУН	жр
ДУСКАНЬЯ	жр
ДУСЬКА	жр
ДУСЯ	жр
ДЫМБРЫЛ	мр
ДЬЮК	мр
ДЭБОРА	жр
ДЭВИД	мр
ДЭЙВ	мр
ДЭЛИЯ	жр
ДЭЛЛА	жр
ДЭЛЯРА	жр
ДЭНИЕЛ	мр
ДЭННИ	мр
ДЭННИС	мр
ДЭЯ	жр
ДЯРЬЯ	жр
ЕВА	жр
ЕВАЛИНА	жр
ЕВАН	мр
ЕВАНГЕЛ	мр
ЕВАНГЕЛИНА	жр
ЕВАНГЕЛИЯ	жр
ЕВАНДЖЕЛИНА	жр
ЕВАНЖЕЛИНА	жр
ЕВАНИЯ	жр
ЕВАНФИЯ	жр
ЕВГАНИЙ	мр
ЕВГАНИЯ	жр
ЕВГЕЙ	мр
ЕВГЕН	мр
ЕВГЕНА	жр
ЕВГЕНИЙ	мр
ЕВГЕНИЯ	жр
ЕВГЕНЬЯ	жр
ЕВГЕНЯ	жр
ЕВГИНИЯ	жр
ЕВГНИЯ	жр
ЕВГННИЯ	жр
ЕВГРАФ	мр
ЕВГРАФЕНА	жр
ЕВГРАФИЙ	мр
ЕВДАКИЯ	жр
ЕВДАНИЯ	жр
ЕВДЕНИЯ	жр
ЕВДИКИЯ	жр
ЕВДИНИЯ	жр
ЕВДИНЬЯ	жр
ЕВДОКИМ	мр
ЕВДОКИНА	жр
ЕВДОКИЯ	жр
ЕВДОКСИЯ	жр
ЕВДОНИЯ	жр
ЕВДОСИЯ	жр
ЕВДОТИЯ	жр
ЕВДОХА	жр
ЕВДОХИМ	мр
ЕВЕКНИЯ	жр
ЕВЕЛИНА	жр
ЕВЕНИЙ	мр
ЕВЕНИЯ	жр
ЕВЕТАЛИЯ	жр
ЕВИЛИНА	жр
ЕВИНИЯ	жр
ЕВКЛИД	мр
ЕВЛАДИЙ	мр
ЕВЛАЛИЯ	жр
ЕВЛАМИЯ	жр
ЕВЛАМНИЯ	жр
ЕВЛАМПИАДА	жр
ЕВЛАМПИЙ	мр
ЕВЛАМПИЯ	жр
ЕВЛАНИЯ	жр
ЕВЛАНТИЙ	мр
ЕВЛАПИЯ	жр
ЕВЛЕНИЯ	жр
ЕВЛИЗАВЕТА	жр
ЕВЛОГИЙ	мр
ЕВЛОКИЯ	жр
ЕВМЕН	мр
ЕВМЕНИЙ	мр
ЕВМЕНТИЙ	мр
ЕВНЕНИЙ	мр
ЕВНЕНИЯ	жр
ЕВНИКА	жр
ЕВОРАЛИЯ	жр
ЕВПАТИЙ	мр
ЕВПРАКСИНЬЯ	жр
ЕВПРАКСИЯ	жр
ЕВРАСИНЬЯ	жр
ЕВРЕНИЙ	мр
ЕВРОНИЯ	жр
ЕВРОСИНИЯ	жр
ЕВРОСИНЬЯ	жр
ЕВСАФИЙ	мр
ЕВСЕЙ	мр
ЕВСЕНИЙ	мр
ЕВСЕНИЯ	жр
ЕВСТАЛИНА	жр
ЕВСТАЛИЯ	жр
ЕВСТАСИЯ	жр
ЕВСТАФИЙ	мр
ЕВСТАФИЯ	жр
ЕВСТАХИЙ	мр
ЕВСТАХИЯ	жр
ЕВСТИГНЕЙ	мр
ЕВСТИХИЙ	мр
ЕВСТОЛИЯ	жр
ЕВСТОЛЬЯ	жр
ЕВСТОМИЯ	жр
ЕВСТОНИЯ	жр
ЕВСТОРИЯ	жр
ЕВСТРАТ	мр
ЕВСТРАТИЙ	мр
ЕВСТРАФИЙ	мр
ЕВТАФИЙ	мр
ЕВТЕНИЯ	жр
ЕВТИФИЙ	мр
ЕВТИХИЙ	мр
ЕВТОЛИЯ	жр
ЕВТРОПИЙ	мр
ЕВТРОПИЯ	жр
ЕВТУХ	мр
ЕВФАЛИЯ	жр
ЕВФАНИЯ	жр
ЕВФИЛИЯ	жр
ЕВФИМИЙ	мр
ЕВФИМИЯ	жр
ЕВФРАСИНИЯ	жр
ЕВФРОЗИНА	жр
ЕВФРОСИНИЯ	жр
ЕВФРОСИНЬЯ	жр
ЕГАНА	жр
ЕГВАРД	мр
ЕГИСАПЕТ	мр
ЕГИШ	мр
ЕГОР	мр
ЕГОРИЙ	мр
ЕГРАФИЙ	мр
ЕДВАРД	мр
ЕДВАРТ	мр
ЕДВИГА	жр
ЕДГАРД	мр
ЕДГОР	мр
ЕДИЗАВЕТА	жр
ЕДОКИЯ	жр
ЕДУАРД	мр
ЕЖИ	мр
ЕЖИНА	жр
ЕКАПИТОЛИНА	жр
ЕКАРИНА	жр
ЕКАТАРИНА	жр
ЕКАТЕРИНА	жр
ЕКАТЕТИНА	жр
ЕКАТИРИНА	жр
ЕКАТРИНА	жр
ЕЛАЗАВЕТА	жр
ЕЛАНА	жр
ЕЛВИН	мр
ЕЛВИРА	жр
ЕЛГУДЖА	жр
ЕЛЕЗАВЕТА	жр
ЕЛЕЗОВЕТА	жр
ЕЛЕНА	жр
ЕЛЕНАЛА	жр
ЕЛЕНКА	жр
ЕЛЕОНОРА	жр
ЕЛЕСЕЙ	мр
ЕЛЕФТЕРИЙ	мр
ЕЛЗА	жр
ЕЛЗАВЕТА	жр
ЕЛИАНА	жр
ЕЛИВЕТА	жр
ЕЛИЗА	жр
ЕЛИЗАВЕНТА	жр
ЕЛИЗАВЕТА	жр
ЕЛИЗАВЕТТА	жр
ЕЛИЗАВИТА	жр
ЕЛИЗАР	мр
ЕЛИЗАРИЙ	мр
ЕЛИЗЕВЕТА	жр
ЕЛИЗОВЕТА	жр
ЕЛИКАНИДА	жр
ЕЛИКОНИДА	жр
ЕЛИНА	жр
ЕЛИОНОРА	жр
ЕЛИСА	жр
ЕЛИСАВЕТА	жр
ЕЛИСЕЙ	мр
ЕЛИСО	мр
ЕЛИСТРАТ	мр
ЕЛИФЕРИЙ	мр
ЕЛЛА	жр
ЕЛЛАДИЙ	мр
ЕЛЛИЗАВЕТА	жр
ЕЛЛИЯ	жр
ЕЛОНА	жр
ЕЛТАЙ	мр
ЕЛЬВИРА	жр
ЕЛЬДАР	мр
ЕЛЬКАНИДА	жр
ЕЛЬМАТ	мр
ЕЛЬМИРА	жр
ЕЛЬНАРА	жр
ЕЛЬФРИДА	жр
ЕМАНУИЛ	мр
ЕМЕЛИНА	жр
ЕМЕЛИЯ	жр
ЕМЕЛИЯН	мр
ЕМЕЛЬЯН	мр
ЕМЕЛЬЯНА	жр
ЕМЗАРИ	мр
ЕМИЛИАН	мр
ЕМИЛИЙ	мр
ЕМИЛИЯ	жр
ЕМИЛИЯН	мр
ЕМИЛЬ	мр
ЕМИЛЬЯН	мр
ЕММАНУЭЛЬ	жр
ЕМУАВЕТА	жр
ЕНАФЬЯ	жр
ЕНГЕЛИНА	жр
ЕНДРЕЙ	мр
ЕНИНА	жр
ЕНОХ	мр
ЕНС	мр
ЕНТА	жр
ЕПЕСТИМИЯ	жр
ЕПИСТИМЕЯ	жр
ЕПИСТИМИЯ	жр
ЕПИСТИНИЯ	жр
ЕПИСТИНЬЯ	жр
ЕПИФАН	мр
ЕПИФАНИЙ	мр
ЕПРАКСИЯ	жр
ЕРАЗИКА	жр
ЕРАН	мр
ЕРАНИК	мр
ЕРАНОС	мр
ЕРАНУШ	мр
ЕРАСТ	мр
ЕРБОЛ	мр
ЕРБОЛАТ	мр
ЕРБУЛАТ	мр
ЕРВАНД	мр
ЕРВАНТ	мр
ЕРВИН	мр
ЕРГЕНИЙ	мр
ЕРГЕНИЯ	жр
ЕРЕМА	мр
ЕРЕМЕЙ	мр
ЕРЕМИЙ	мр
ЕРЕНА	жр
ЕРИКА	жр
ЕРИХ	мр
ЕРКЕ	мр
ЕРКЕБУЛАН	мр
ЕРКЕЖАН	мр-жр
ЕРКЕН	мр
ЕРКИН	мр
ЕРКИЯ	мр
ЕРМАК	мр
ЕРМЕК	мр
ЕРМЕКБАЙ	мр
ЕРМИЛ	мр
ЕРМИЛА	мр
ЕРМИНГЕЛЬД	мр
ЕРМИНИНГЕЛЬД	мр
ЕРМОЛ	мр
ЕРМОЛАЙ	мр
ЕРНЕЙ	мр
ЕРНЕСТ	мр
ЕРНСТ	мр
ЕРОСЛАВ	мр
ЕРОСЛАВА	жр
ЕРОТЕИДА	жр
ЕРОТИАДА	жр
ЕРОТИИДА	жр
ЕРОФЕЙ	мр
ЕРОХИМ	мр
ЕСЕНИЯ	жр
ЕСМИРА	жр
ЕСТЕР	жр
ЕТАР	мр
ЕУЖЕНИЯ	жр
ЕУФИМИЯ	жр
ЕУФРОЗИНА	жр
ЕФАЛЬЯ	жр
ЕФДОКИЯ	жр
ЕФИМ	мр
ЕФИМИЙ	мр
ЕФИМИЯ	жр
ЕФИМЬЯ	жр
ЕФОСИНЬЯ	жр
ЕФРАСИНИЯ	жр
ЕФРАСИНЬЯ	жр
ЕФРАСИЯ	жр
ЕФРЕМ	мр
ЕФРЕМИЙ	мр
ЕФРОКСИНЬЯ	жр
ЕФРОСЕНИЯ	жр
ЕФРОСЕНЬЯ	жр
ЕФРОСИМА	жр
ЕФРОСИМЬЯ	жр
ЕФРОСИНА	жр
ЕФРОСИНИЙ	мр
ЕФРОСИНИЯ	жр
ЕФРОСИНЬЯ	жр
ЕФРОСИНЯ	жр
ЕФРОСИЯ	жр
ЕФСТАФИЙ	мр
ЕФТЕЙ	мр
ЕФТЕМИЙ	мр
ЕФТЕНИЙ	жр
ЕФТИМИЯ	жр
ЕФФАЛИЯ	жр
ЖАВДЕТ	мр
ЖАВЕР	мр
ЖАВИД	мр
ЖАВИТ	мр
ЖАВЛОНБЕК	мр
ЖАДРА	жр
ЖАЗИРА	жр
ЖАЙРАН	мр
ЖАК	мр
ЖАКЛИН	жр
ЖАКСЛЫК	мр
ЖАМАЛ	мр
ЖАМАЛАДДИН	мр
ЖАМАЛДИН	мр
ЖАМАЛЕТДИН	мр
ЖАМАЛИДИН	мр
ЖАМАЛУДИН	мр
ЖАМАЛЬ	мр
ЖАМАЛЬДИН	мр
ЖАМБАЛ	мр
ЖАМБЕК	мр
ЖАМБУЛАТ	мр
ЖАМИЛ	мр
ЖАМИЛИЯ	жр
ЖАМИЛЯ	жр
ЖАМОЛАДДИН	мр
ЖАМСАРАН	мр
ЖАН	мр
ЖАН-КЛОД	мр
ЖАН-ПОЛ	мр
ЖАН-ПОЛЬ	мр
ЖАН-ПЬЕР	мр
ЖАНАБЕК	мр
ЖАНЕЛЬ	жр
ЖАНЕТ	жр
ЖАНЕТА	жр
ЖАНЕТТ	жр
ЖАНЕТТА	жр
ЖАНЖАК	мр
ЖАНИБЕК	мр
ЖАНИЕТА	жр
ЖАННА	жр
ЖАННАТ	мр
ЖАННАТА	жр
ЖАННЕТА	жр
ЖАННЕТТА	жр
ЖАННЭТА	жр
ЖАННЭТТА	жр
ЖАНРИЭТА	жр
ЖАНРИЭТТА	жр
ЖАНТЕМИР	мр
ЖАНЭТА	жр
ЖАНЭТТА	жр
ЖАРГАЛ	мр
ЖАРГАЛСАЙХАН	мр
ЖАРЖЕТТА	жр
ЖАРМЕНА	жр
ЖАСМИНА	жр
ЖАСУЛАН	мр
ЖАСУР	мр
ЖАСУРБЕК	мр
ЖАФАР	мр
ЖДАНА	жр
ЖДИХАН	мр
ЖЕЗЕФИНА	жр
ЖЕЗОФИНА	жр
ЖЕЛЬВИРА	жр
ЖЕМАЛЕДИН	мр
ЖЕМАЛИЯ	жр
ЖЕМИЛА	жр
ЖЕМИЛЯ	жр
ЖЕМИРА	жр
ЖЕНАИДА	жр
ЖЕНЕВЬЕВА	жр
ЖЕНЕТА	жр
ЖЕНЕТТА	жр
ЖЕНЕЧКА	жр
ЖЕНИКА	жр
ЖЕНИЯ	жр
ЖЕННА	жр
ЖЕННЕТА	жр
ЖЕННЕТТА	жр
ЖЕННИ	жр
ЖЕНОИДА	жр
ЖЕНЬКА	жр
ЖЕНЯ	жр-жр
ЖЕОРЖЕТА	жр
ЖЕОРЖЕТТА	жр
ЖЕРАР	мр
ЖЕРМЕНА	жр
ЖЕРМИНА	жр
ЖЕРОМ	мр
ЖЕСМИНА	жр
ЖИАНЕТА	жр
ЖИГАНИЯ	жр
ЖИГЖИТ	мр
ЖИЗЕЛЬ	жр
ЖОАКИМ	мр
ЖОЗЕ	мр
ЖОЗЕФА	жр
ЖОЗЕФИНА	жр
ЖОЛДАСБАЙ	мр
ЖОЛТ	мр
ЖОНЕТТА	жр
ЖОРА	мр
ЖОРЕС	мр
ЖОРЖ	мр
ЖОРЖЕТА	жр
ЖОРЖЕТТА	жр
ЖОРЖИК	мр
ЖОРЖИНА	жр
ЖОРИЙ	мр
ЖОФФРЕЙ	мр
ЖУАН	мр
ЖУАНА	жр
ЖУАННА	жр
ЖУЖАНА	жр
ЖУЖАННА	жр
ЖУЖИНА	жр
ЖУЖУНА	жр
ЖУЛЕТА	жр
ЖУЛЕТТА	жр
ЖУЛЬЕТА	жр
ЖУЛЬЕТТА	жр
ЖЮЛЬЕТТА	жр
ЗАБАР	мр
ЗАБЕЛА	жр
ЗАБЕЛИНА	жр
ЗАБЕЛЛА	жр
ЗАБИ	мр
ЗАБИДА	жр
ЗАБИОЛЛА	жр
ЗАБИР	мр
ЗАБИРА	жр
ЗАБИРЯ	жр
ЗАБИУЛЛАХ	мр
ЗАБИХУЛЛА	мр
ЗАБИЯ	жр
ЗАВДАТ	мр
ЗАГИД	мр
ЗАГИДУЛ	мр
ЗАГИДУЛЛА	мр
ЗАГИР	мр
ЗАГИРЯ	мр
ЗАГИТ	мр
ЗАГРЕЙ	мр
ЗАГРЕТДИН	мр
ЗАГРУТДИН	мр
ЗАЗА	мр
ЗАИНИДИН	мр
ЗАИРА	жр
ЗАЙГА	жр
ЗАЙГУНА	жр
ЗАЙНАБ	жр
ЗАЙНУЛЛА	мр
ЗАЙНУТДИН	мр
ЗАЙТИНА	жр
ЗАЙТУНА	жр
ЗАК	мр
ЗАКАРИЯ	мр
ЗАКИР	мр
ЗАКИУЛ	мр
ЗАКИЯ	мр-жр
ЗАЛИЛЯ	жр
ЗАЛИМКАН	мр
ЗАЛИМХАН	мр
ЗАЛИНА	жр
ЗАЛИФА	жр
ЗАЛИФЕ	жр
ЗАЛИФЯ	жр
ЗАЛИХА	жр
ЗАЛИХМАН	мр
ЗАЛМАН	мр
ЗАЛУМХАН	мр
ЗАЛЬФИНА	жр
ЗАЛЬФИРА	жр
ЗАМАМ	мр
ЗАМЕДДИН	мр
ЗАМФИРА	жр
ЗАНФИРА	жр
ЗАНФИРЯ	жр
ЗАНХИРА	жр
ЗАНЭ	жр
ЗАПРЯН	мр
ЗАРА	жр
ЗАРАТУСТРА	мр
ЗАРАФУТДИН	мр
ЗАРЕМА	жр
ЗАРЕММА	жр
ЗАРЕНА	жр
ЗАРЕСЛАВА	жр
ЗАРИГ	мр
ЗАРИМА	жр
ЗАРИНА	жр
ЗАРИНАТ	мр
ЗАРИНБАЙ	мр
ЗАРИП	мр
ЗАРИФ	мр
ЗАРИФА	жр
ЗАРИЯ	жр
ЗАРНИЯР	мр
ЗАРОБИДДИН	мр
ЗАРРИНА	жр
ЗАРУИЙ	мр
ЗАУР	мр
ЗАУРА	жр
ЗАУРБЕГ	мр
ЗАУРБЕК	мр
ЗАУРБИ	мр
ЗАУРЕ	жр
ЗАУРЕМ	мр
ЗАУРЕШ	жр
ЗАУРИ	мр
ЗАУРИЙ	мр
ЗАУРИН	мр
ЗАУРИЯ	жр
ЗАФАР	мр
ЗАФАРДЖАН	мр
ЗАФЕР	мр
ЗАХАР	мр
ЗАХАРИЙ	мр
ЗАХАРИЯ	мр-жр
ЗАХИД	мр
ЗАХИР	мр
ЗБИГНЕВ	мр
ЗБИГНЕР	мр
ЗБИГНИЕВ	мр
ЗВЕНИСЛАВ	мр
ЗВЕНИСЛАВА	жр
ЗВИАД	мр
ЗВОНИМИР	мр
ЗДЕСЛАВ	мр
ЗДЗИСЛАВ	мр
ЗДИСЛАВ	мр
ЗДИСЛАВА	жр
ЗЕБО	жр
ЗЕБУНИСО	жр
ЗЕБУНИССО	жр
ЗЕЙНАБ	мр
ЗЕЙНАЛ	мр
ЗЕЙНАЛАБДИН	мр
ЗЕЙНЕБ	мр
ЗЕЙНЕВ	мр
ЗЕЙНЕК	мр
ЗЕЙНЕН	мр
ЗЕЙНЕП	жр
ЗЕЙНЕР	мр
ЗЕЙНЕТ	мр
ЗЕКЕРИЯ	мр
ЗЕЛЕНТ	мр
ЗЕЛИМКАН	мр
ЗЕЛЬДА	жр
ЗЕЛЬМА	жр
ЗЕЛЬМАН	мр
ЗЕЛЬМИРА	жр
ЗЕЛЬФА	жр
ЗЕЛЬФИГАР	мр
ЗЕЛЬФИРА	жр
ЗЕЛЬФИЯ	жр
ЗЕМИНА	жр
ЗЕМИРА	жр
ЗЕМПЕРА	жр
ЗЕМФЕРА	жр
ЗЕМФИРА	жр
ЗЕНАИДА	жр
ЗЕНОВЕЯ	жр
ЗЕНОВИЙ	мр
ЗЕНОВИЯ	жр
ЗЕНОИДА	жр
ЗЕНОН	мр
ЗЕНФЕРА	жр
ЗЕНФИРА	жр
ЗЕФИРА	жр
ЗЕФИРИНА	жр
ЗЕФРИДА	жр
ЗИГИЗМУНД	мр
ЗИГМУНД	мр
ЗИГМУНТ	мр
ЗИГРИДА	жр
ЗИГРЯ	жр
ЗИГФРИД	мр
ЗИГФРИДА	жр
ЗИДАИДА	жр
ЗИКФРИД	мр
ЗИЛГА	жр
ЗИЛЬФАР	мр
ЗИЛЬФИРА	жр
ЗИЛЯ	жр
ЗИНА	жр
ЗИНАИДА	жр
ЗИНАРА	жр
ЗИНАТУЛЛА	мр
ЗИНКА	жр
ЗИННУР	мр
ЗИНОВЕЙ	мр
ЗИНОВИЙ	мр
ЗИНОВИЯ	жр
ЗИНОВЬЯ	жр
ЗИНОН	мр
ЗИНОЧКА	жр
ЗИРА	жр
ЗИРАИДА	жр
ЗИТА	жр
ЗИФИРА	жр
ЗИФКАТ	мр
ЗИФРИД	мр
ЗИФРИДА	жр
ЗИЯД	мр
ЗЛАТА	жр
ЗЛАТАНА	жр
ЗЛАТАСЛАВА	жр
ЗЛАТИНА	жр
ЗЛАТИСЛАВА	жр
ЗЛАТИЯ	жр
ЗЛАТОСЛАВА	жр
ЗОЗАНА	жр
ЗОЛИФА	жр
ЗОЛИЯ	жр
ЗОЛТАН	мр
ЗОЛЬДА	жр
ЗОЛЬФИЯ	жр
ЗОЛЬХИЯ	жр
ЗОМАН	мр
ЗОРА	жр
ЗОРАН	мр
ЗОРЕНА	жр
ЗОРЕСЛАВ	мр
ЗОРЕСЛАВА	жр
ЗОРИНА	жр
ЗОРЬЯН	мр
ЗОРЯН	мр
ЗОРЯНА	жр
ЗОСИМ	мр
ЗОСИМА	мр
ЗОСИЯ	жр
ЗОСХАН	мр
ЗОСЯ	жр
ЗОТИК	мр
ЗОФИЯ	жр
ЗОФЬЯ	жр
ЗОЯ	жр
ЗУБАЛА	мр
ЗУЗАНИЯ	жр
ЗУЗАННА	жр
ЗУЛХИЖАТ	жр
ЗУЛХИЯ	жр
ЗУЛЬНАРА	жр
ЗУЛЬФИЯ	жр
ЗУЛЯ	жр
ЗУЛЯЙХА	жр
ЗУРАБ	мр
ЗУРИКО	жр
ЗУРИЯ	жр
ЗУФАР	мр
ЗУФАРА	жр
ЗУХРА	жр
ЗУХРАБ	мр
ЗУХРАБЕК	мр
ЗУХРАХОН	мр
ЗЮГРА	жр
ЗЮДЕР	мр
ЗЮЛЬФИРА	жр
ЗЮЛЬФИЯ	жр
ЗЯЙНЯП	мр
ЗЯМА	мр
ИАИТЯНА	жр
ИАКИМ	мр
ИАКОВ	мр
ИАМАРА	жр
ИАНИНА	жр
ИАННА	жр
ИАНУАРИЙ	мр
ИАРИДА	жр
ИАРИЯ	жр
ИБОЛЯ	жр
ИБОЯ	жр
ИБРАГИМ	мр
ИБРАГИН	мр
ИБРАХИМ	мр
ИВ	мр
ИВАН	мр
ИВАНГ	мр
ИВАНЕС	мр
ИВАНИ	мр
ИВАНИДА	жр
ИВАНИНА	жр
ИВАНИЯ	жр
ИВАНКА	жр
ИВАНКО	мр
ИВАННА	жр
ИВАР	мр
ИВАРД	мр
ИВАРИ	мр
ИВАРС	мр
ИВАСЬ	мр
ИВДОКИЯ	жр
ИВЕЛИН	мр
ИВЕЛИНА	жр
ИВЕР	мр
ИВЕТТА	жр
ИВИЛИНА	жр
ИВИТА	жр
ИВИЯ	жр
ИВЛИЙ	мр
ИВЛИТА	жр
ИВОН	мр
ИВОНИНА	жр
ИВОНКА	жр
ИВОННА	жр
ИВСТАЛИЙ	мр
ИГАЛЬ	мр
ИГНАТ	мр
ИГНАТИЙ	мр
ИГОР	мр
ИГОРЁК	мр
ИГОРЬ	мр
ИГРАМУДДИН	мр
ИГРАМУДИН	мр
ИДА	жр
ИДАЛИНА	жр
ИДАЛИЯ	жр
ИДЕАЛИНА	жр
ИДЕЛАИДА	жр
ИДЕЛИЯ	жр
ИДИБЕК	мр
ИДИНА	жр
ИДИЯ	жр
ИДРИС	мр
ИЕГОВА	мр-жр
ИЕГУДИ	мр
ИЕРОНИМ	мр
ИЕШУА	мр
ИЗА	жр
ИЗАБЕЛА	жр
ИЗАБЕЛЛА	жр
ИЗАБЕЛЬ	жр
ИЗАБЭЛА	жр
ИЗАБЭЛЛА	жр
ИЗАДОРА	жр
ИЗАИДА	жр
ИЗАННА	жр
ИЗАТУЛЛО	мр
ИЗИДА	жр
ИЗИЙ	мр
ИЗИСЛАВ	мр
ИЗМАИЛ	мр
ИЗОБЕЛА	жр
ИЗОБЕЛЛА	жр
ИЗОБЭЛЛА	жр
ИЗОДОРА	жр
ИЗОЛИНА	жр
ИЗОЛЬДА	жр
ИЗОЛЬДИЯ	жр
ИЗОСИМ	мр
ИЗОТ	мр
ИЗРАИЛЬ	мр
ИЗЬЯСЛАВ	мр
ИЗЯ	мр
ИЗЯСЛАВ	мр
ИЗЯСЛАВА	жр
ИИСУС	мр
ИКАР	мр
ИКАРИЙ	мр
ИКИЛИНА	жр
ИКРАМЖАН	мр
ИКРАН	мр
ИЛАН	мр
ИЛАНА	жр
ИЛАННА	жр
ИЛАРИЙ	мр
ИЛАРИОН	мр
ИЛГАМИЯ	жр
ИЛДЫР	мр
ИЛЕАНА	жр
ИЛЕОНОРА	жр
ИЛЗА	жр
ИЛЗЕ	жр
ИЛИАН	мр
ИЛИАНА	жр
ИЛИАНОРА	жр
ИЛИЗАВЕТА	жр
ИЛИЗАР	мр
ИЛИОДОР	мр
ИЛИОНОРА	жр
ИЛИСА	жр
ИЛИСЯ	жр
ИЛЛАР	мр
ИЛЛАРИЙ	мр
ИЛЛАРИОН	мр
ИЛЛАРИЯ	жр
ИЛЛИНА	жр
ИЛЛИРИЯ	жр
ИЛМАР	мр
ИЛМАРС	мр
ИЛОНА	жр
ИЛОНКА	жр
ИЛОННА	жр
ИЛХОМ	мр
ИЛХОМДЖОН	мр
ИЛХОМЖАН	мр
ИЛХОМИДИН	мр
ИЛЬВАР	мр
ИЛЬВЕРА	жр
ИЛЬВИНА	жр
ИЛЬВИРА	жр
ИЛЬГАМ	мр
ИЛЬГАМА	жр
ИЛЬГАМИЯ	жр
ИЛЬГАМЬЯ	жр
ИЛЬГАН	мр
ИЛЬГАР	мр
ИЛЬГАРД	мр
ИЛЬГЕС	мр
ИЛЬГИД	мр
ИЛЬГИЗ	мр
ИЛЬГИЗАР	мр
ИЛЬДАР	мр
ИЛЬДОР	мр
ИЛЬДОС	мр
ИЛЬДУР	мр
ИЛЬДУС	мр
ИЛЬДУСЬ	мр
ИЛЬДЮС	мр
ИЛЬЗАТ	мр
ИЛЬИНА	жр
ИЛЬМАР	мр
ИЛЬМАРС	мр
ИЛЬМИР	мр
ИЛЬМИРА	жр
ИЛЬНАРА	жр
ИЛЬНУР	мр
ИЛЬНУРА	жр
ИЛЬСИЯР	жр
ИЛЬХАМ	мр
ИЛЬХАМА	жр
ИЛЬХАМБЕК	мр
ИЛЬХАМИЯ	жр
ИЛЬХАН	мр
ИЛЬШАТ	мр
ИЛЬЯ	мр
ИЛЬЯЗ	мр
ИЛЬЯНОРА	жр
ИЛЬЯНУР	мр
ИЛЬЯР	мр
ИЛЬЯС	мр
ИЛЬЯСАФ	мр
ИЛЬЯСХАН	мр
ИЛЬЯШ	мр
ИЛЮЗА	жр
ИЛЮША	мр
ИЛЯНА	жр
ИЛЯРИЙ	мр
ИМАД	мр
ИМАЛ	мр
ИМАМАЛИ	мр
ИМАМЕДДИН	мр
ИМАМЕДИН	мр
ИМАМУДИН	мр
ИМАМУТДИН	мр
ИМАН	мр
ИМАНАКЫШ	мр
ИМАНТ	мр
ИМАНУИЛ	мр
ИМЕД	мр
ИМЕЛЬДА	жр
ИМОМАЛИ	мр
ИМРАН	мр
ИМРЕ	мр
ИНАДИЯ	жр
ИНАИДА	жр
ИНАИСА	жр
ИНАЛ	мр
ИНАР	мр
ИНАРА	жр
ИНАРС	мр
ИНВЕР	мр
ИНГА	жр
ИНГВАР	мр
ИНГЕБОРГА	жр
ИНГРИД	жр
ИНГРИДА	жр
ИНГРИТА	жр
ИНДИРА	жр
ИНДРЕК	мр
ИНДУЛИС	мр
ИНЕЛИНА	жр
ИНЕС	жр
ИНЕСА	жр
ИНЕСЕ	жр
ИНЕССА	жр
ИНЕССЕ	жр
ИННА	жр
ИННАИДА	жр
ИННЕСА	жр
ИННЕССА	жр
ИННЕТА	жр
ИННОКЕНТИЙ	мр
ИННОСЕНТ	мр
ИННЭСА	жр
ИННЭССА	жр
ИНОКЕНТИЙ	мр
ИНРИЕТТА	жр
ИНРИНА	жр
ИНСАФ	мр
ИНТЕРИНА	жр
ИНТЕРИЯ	жр
ИНТЕРНА	жр
ИНТИГАМ	мр
ИОАКИМ	мр
ИОАН	мр
ИОАНН	мр
ИОАННА	жр
ИОАННИС	мр
ИОАСАФ	мр
ИОАХИМ	мр
ИОВ	мр
ИОВАННА	жр
ИОГАНН	мр
ИОГАННА	жр
ИОЖЕФ	мр
ИОЗАПАС	мр
ИОЗАС	мр
ИОЗЕФИНА	жр
ИОЗИФ	мр
ИОЛАНА	жр
ИОЛАНДА	жр
ИОЛАННА	жр
ИОЛАНТА	жр
ИОН	мр
ИОНА	мр-жр
ИОНАС	мр
ИОННА	жр
ИОСАФАТ	мр
ИОСИП	мр
ИОСИФ	мр
ИОСИФИНА	жр
ИПАТ	мр
ИПАТИЙ	мр
ИППОЛИТ	мр
ИРА	жр
ИРАГИ	жр
ИРАДА	жр
ИРАДЕ	жр
ИРАДЖ	мр
ИРАДИАДА	жр
ИРАДИОН	мр
ИРАЗИЯТ	мр
ИРАИДА	жр
ИРАИНА	жр
ИРАИНДА	жр
ИРАИСА	жр
ИРАЙДА	жр
ИРАКЛИ	мр
ИРАКЛИЙ	мр
ИРАЛИЯ	жр
ИРАНДА	жр
ИРАНЗА	жр
ИРАНИЯ	жр
ИРАТ	мр
ИРАТИАДА	жр
ИРБЕК	мр
ИРВИН	мр
ИРГАЛИЙ	мр
ИРГАШ	жр
ИРЕЙНА	жр
ИРЕК	мр
ИРЕНА	жр
ИРЕНЕ	жр
ИРЕНЕЙ	мр
ИРЕНЕУШ	мр
ИРЕНЭ	жр
ИРЖА	жр
ИРЖИ	мр
ИРЖИНА	жр
ИРЗА	мр-жр
ИРИ	жр
ИРИАДА	жр
ИРИАН	мр
ИРИАНА	жр
ИРИАНДА	жр
ИРИДА	жр
ИРИДИЯ	жр
ИРИИДА	жр
ИРИКА	жр
ИРИНА	жр
ИРИНААНА	жр
ИРИНАИДА	жр
ИРИНЕЙ	мр
ИРИНИЙ	мр
ИРИНИЯ	жр
ИРИНКА	жр
ИРИНЬЯ	жр
ИРИСА	жр
ИРИТА	жр
ИРЛАНДА	жр
ИРМА	жр
ИРМАН	мр
ИРМАНТАС	мр
ИРМАТ	мр
ИРМИНА	жр
ИРОДИАДА	жр
ИРОНДА	жр
ИРФАН	мр
ИРЭН	жр
ИРЭНА	жр
ИРЭНЭ	жр
ИСА	мр
ИСААК	мр
ИСААКИЙ	мр
ИСАЙ	мр
ИСАК	мр
ИСАКИЙ	мр
ИСАМ	мр
ИСАМАГОМЕД	мр
ИСАМЕТДИН	мр
ИСАМИДИН	мр
ИСАМУТДИН	мр
ИСИДОР	мр
ИСИДОРА	жр
ИСКАНДАР	мр
ИСКАНДАРБЕК	мр
ИСКАНДЕР	мр
ИСКАНДЕРБЕК	мр
ИСКЕНДАР	мр
ИСКЕНДЕР	мр
ИСЛАМ	мр
ИСЛАМБЕК	мр
ИСЛАМГАЛЕЙ	мр
ИСЛЯМ	мр
ИСМАГИЛ	мр
ИСМАИЛ	мр
ИСМАЙЛ	мр
ИСМАТ	мр
ИСМЕТ	мр
ИССА	жр
ИССЬ	мр
ИСТОРА	жр
ИСФАНДИЯР	мр
ИСХАК	мр
ИСХОК	мр
ИТТИФАК	мр
ИТХАИЛ	мр
ИУВИНАЛИЙ	мр
ИУЛИАНИЯ	жр
ИУЛЬЯНИЯ	жр
ИУМАНИЯ	жр
ИУСТИН	мр
ИУСТИНА	жр
ИУСТИНИЯ	жр
ИУСТИНЬЯ	жр
ИФИГЕНИЯ	жр
ИЦХАК	мр
ИШБУЛАТ	мр
ИШБУЛДЫ	мр
ИШГИЛЬДЫ	мр
ИШМУХАМЕТ	мр
ИШТВАН	мр
ИШТУГАН	мр
ИЮВИНАЛИЙ	мр
ИЮЛИЙ	мр
ИЯ	жр
ЙВАН	мр
ЙЕНС	мр
ЙИРЖИ	мр
ЙОАН	мр
ЙОВА	мр
ЙОВАН	мр
ЙОВАНКА	жр
ЙОГАН	мр
ЙОГАННЕС	мр
ЙОЖЕФ	мр
ЙОЗАС	мр
ЙОЗЕФ	мр
ЙОКО	жр
ЙОЛАНА	жр
ЙОЛАНТА	жр
ЙОЛИТА	жр
ЙОМЕР	мр
ЙОНАС	мр
ЙОНАТАН	мр
ЙОРГ	мр
ЙОРГЕН	мр
ЙОРДАНКА	жр
ЙОСЕФ	мр
ЙОСИП	мр
ЙОСИФ	мр
ЙОХАНЕС	мр
ЙОХАННЕС	мр
КААДЫР	мр
КААДЫР-ООЛ	мр
КАБИР	мр
КАБИРА	жр
КАВДИЯ	жр
КАВИТА	жр
КАДАМБАЙ	мр
КАДАМБОЙ	мр
КАДАРИЯ	жр
КАДИР	мр
КАДИРБЕК	мр
КАДИРБЕРГЕН	мр
КАДИРИЯ	жр
КАДРИЯ	жр
КАДЫР	мр
КАДЫРБЕК	мр
КАДЫРГУЛА	мр
КАДЫРИЯ	жр
КАДЫРЬЯ	жр
КАЗБЕК	мр
КАЗБУЛАТ	мр
КАЗЕМИРА	жр
КАЗИМ	мр
КАЗИМА	жр
КАЗИМАГОМЕД	мр
КАЗИМБЕК	мр
КАЗИМИР	мр
КАЗИМИРА	жр
КАЗИМИРАС	мр
КАЗМИРА	жр
КАЗЫБЕК	мр
КАЗЬМА	мр
КАЙ	мр
КАЙЛИСТА	жр
КАЙРАТ	мр
КАЙРОЛЛА	мр
КАЙЮС	мр
КАКАБАЙ	мр
КАКИМБЕК	мр
КАЛАМБИНА	жр
КАЛАМУТДИН	мр
КАЛЕВ	мр
КАЛЕН	мр
КАЛЕНТИЙ	мр
КАЛЕРИНА	жр
КАЛЕРИЯ	жр
КАЛИЛИЯ	жр
КАЛИМА	жр
КАЛИМУЛА	жр
КАЛИМУЛЛА	мр
КАЛИМЯ	жр
КАЛИНЕ	жр
КАЛИНИЯ	жр
КАЛИОПА	жр
КАЛИСА	жр
КАЛИСИЯ	жр
КАЛИССА	жр
КАЛИСТА	жр
КАЛИСТВЕНИЯ	жр
КАЛИСТРА	мр
КАЛИСТРАТ	мр
КАЛИТ	мр
КАЛИФ	мр
КАЛИЯ	жр
КАЛЛЕРИЯ	жр
КАЛЛИСТА	жр
КАЛЛИСТРАТ	мр
КАЛМАН	мр
КАЛЬВЕРО	мр
КАЛЬМИНА	жр
КАМАЛ	мр
КАМАЛЕДДИН	мр
КАМАЛЕТДИН	мр
КАМАЛИТДИН	мр
КАМАЛУДИН	мр
КАМАЛУТДИН	мр
КАМАЛЬ	мр
КАМЕЛЬ	мр
КАМИЛ	мр
КАМИЛА	жр
КАМИЛИЯ	жр
КАМИЛЛА	жр
КАМИЛЛИЯ	жр
КАМИЛЬ	мр
КАМИЛЯ	жр
КАМРОН	мр
КАНАН	мр
КАНАРЕЙ	мр
КАНАФИЙ	мр
КАНТЕМИР	мр
КАНТИМИР	мр
КАПА	жр
КАПЕТОЛИНА	жр
КАПИТАЛИНА	жр
КАПИТОЛИНА	жр
КАПИТОН	мр
КАРАТАЙ	мр
КАРДЕЛИЯ	жр
КАРЕН	мр
КАРИМ	мр
КАРИМА	жр
КАРИМБЕК	мр
КАРИН	жр
КАРИНА	жр
КАРИНЕ	жр
КАРИННА	жр
КАРИНЭ	жр
КАРЛ	мр
КАРЛА	жр
КАРЛИНА	жр
КАРЛИС	мр
КАРЛО	мр
КАРЛОТА	жр
КАРЛУШ	мр
КАРЛЫГАШ	мр
КАРМЕЛА	жр
КАРМЕЛИТА	жр
КАРМЕЛИЯ	жр
КАРМЕЛЛА	жр
КАРМЕН	жр
КАРМЕНА	жр
КАРМИЛА	жр
КАРМИЯ	жр
КАРОЛА	жр
КАРОЛАЙН	жр
КАРОЛИН	жр
КАРОЛИНА	жр
КАРП	мр
КАРПЕТ	мр
КАРПИЙ	мр
КАРПИС	мр
КАРСТЕН	мр
КАРЭН	жр
КАСБУЛАТ	мр
КАСЕМ	мр
КАСИАН	мр
КАСИМ	мр
КАСИНИЯ	жр
КАСПЕР	мр
КАССАНДРА	жр
КАСЬЯН	мр
КАСЬЯНА	жр
КАСЯ	жр
КАСЯН	мр
КАСЯНА	жр
КАТАЖИНА	жр
КАТАЛИН	жр
КАТАЛИНА	жр
КАТАНА	жр
КАТАРЖИНА	жр
КАТАРИНА	жр
КАТЕЛИНА	жр
КАТЕРИНА	жр
КАТИРИНА	жр
КАТОЛИНА	жр
КАТРИ	жр
КАТРИН	жр
КАТРИНА	жр
КАТРЯ	жр
КАТЬКА	жр
КАТЯ	жр
КАФИЛЬ	мр
КАФИЯ	жр
КАХАБЕР	мр
КАХРАМАН	мр
КАШФУЛЛА	мр
КАЮМ	мр
КАЯНЭ	жр
КВЕНТИН	мр
КВЕТА	жр
КВЕТОСЛАВ	мр
КВЕТОСЛАВА	жр
КЕВИН	мр
КЕВОРК	мр
КЕВСЕР	мр
КЕН	мр
КЕНЖЕ	жр
КЕНЖЕБЕК	мр
КЕНЖЕХАН	мр
КЕНЖЕШ	мр
КЕРИМ	мр
КЕРИМБЕК	мр
КЕРСТИН	жр
КЕРТА	жр
КЕРТТА	жр
КЕРТУ	жр
КЕРТУЛАЙ	мр
КЕСАРИЯ	жр
КЕТИ	жр
КИАРА	жр
КИВЕН	мр
КИЗХАНУМ	мр
КИКИЛИЯ	жр
КИЛИНА	жр
КИМ	мр-жр
КИМА	жр
КИМИК	мр
КИММА	жр
КИММО	мр
КИПРИАН	мр
КИПРИЯН	мр
КИПРИЯНО	мр
КИРА	жр
КИРАИДА	жр
КИРАНА	жр
КИРЕЙ	мр
КИРИ	мр-жр
КИРИАК	мр
КИРИАННА	жр
КИРИЕНА	жр
КИРИЕННА	жр
КИРИЙ	мр
КИРИКИЯ	мр
КИРИЛ	мр
КИРИЛИНА	жр
КИРИЛИЯ	жр
КИРИЛЛ	мр
КИРИЛЛИНА	жр
КИРИМ	мр
КИРИМБАЙ	мр
КИРОЛИНА	жр
КИРСАН	мр
КИРЬЯК	мр
КЛАВА	жр
КЛАВДЕЯ	жр
КЛАВДИА	жр
КЛАВДИЙ	мр
КЛАВДИЯ	жр
КЛАВДИЯН	мр
КЛАВИЙ	мр
КЛАВИЯ	жр
КЛАВКА	жр
КЛАДИЯ	жр
КЛАЙ	мр
КЛАЙВ	мр
КЛАРА	жр
КЛАРИДА	жр
КЛАРИЙ	мр
КЛАРИНА	жр
КЛАРИС	жр
КЛАРИСА	жр
КЛАРИССА	жр
КЛАРИТА	жр
КЛАРИЯ	жр
КЛАРК	мр
КЛАРОЧКА	жр
КЛАУДИА	жр
КЛАУДИО	мр
КЛАУДИЯ	жр
КЛАУС	мр
КЛАШ	мр
КЛАША	жр
КЛЕМЕНТ	мр
КЛЕМЕНТИЙ	мр
КЛЕМЕНТИНА	жр
КЛЕОНИК	мр
КЛЕОПАТРА	жр
КЛЕОФАС	мр
КЛЕРА	жр
КЛЕРИЯ	жр
КЛЕСТИЛЬ	мр
КЛИМ	мр
КЛИМЕНТ	мр
КЛИМЕНТИЙ	мр
КЛИМЕНТИНА	жр
КЛИМЕНТИЯ	жр
КЛИНТ	мр
КЛИОПАТРА	жр
КЛОДИЯ	жр
КЛЭР	жр
КНАРИК	мр
КОБИ	мр
КОЗИМАГОМЕД	мр
КОЗИМИР	мр
КОЗЬМА	мр
КОЗЬМЬ	жр
КОЛА	жр
КОЛЕНЬКА	мр
КОЛИБАБ	мр
КОЛИН	мр
КОЛИСТРАТ	мр
КОЛЬКА	мр
КОЛЮНЧИК	мр
КОЛЮНЯ	мр
КОЛЮША	мр
КОЛЯ	мр
КОМУНАРА	жр
КОНГ	мр
КОНДОЛИЗА	жр
КОНДРАТ	мр
КОНДРАТИЙ	мр
КОНКОРДИЙ	мр
КОНКОРДИЯ	жр
КОНОН	мр
КОНРАД	мр
КОНСТАНТИН	мр
КОНСТАНЦИЯ	жр
КОРИНА	жр
КОРИННА	жр
КОРНЕЙ	мр
КОРНЕЛ	мр
КОРНЕЛИЙ	мр
КОРНЕЛИУС	мр
КОРНЕЛИЯ	жр
КОРНИЛ	мр
КОРНИЛИЙ	мр
КОРНИЛИЯ	жр
КОРОЛИНА	жр
КОРТНИ	жр
КОСИМ	мр
КОСТА	мр
КОСТАН	мр
КОСТАНТИН	мр
КОСТАНЦИЯ	жр
КОСТЯ	мр
КОСТЯНТИН	мр
КОФИ	мр
КРАСИМИРА	жр
КРАСНОАРМИНА	жр
КРАСНОМИР	мр
КРАСНОМИРА	жр
КРАСНОСЛАВ	мр
КРЕЙГ	мр
КРЕМЛИНА	жр
КРЕСТИНА	жр
КРЕСТИНИЯ	жр
КРЕСТИНЬЯ	жр
КРИМГИЛЬДА	жр
КРИС	мр
КРИСКЕНТИЯ	жр
КРИСТА	жр
КРИСТАЛ	мр
КРИСТАЛИНА	жр
КРИСТАНА	жр
КРИСТАФОР	мр
КРИСТЕЛЬ	жр
КРИСТИАН	мр
КРИСТИАНА	жр
КРИСТИАНЕ	жр
КРИСТИАНЭ	жр
КРИСТИН	жр
КРИСТИНА	жр
КРИСТИНЕ	жр
КРИСТИНИЯ	жр
КРИСТИНЭ	жр
КРИСТИЯН	мр
КРИСТО	мр
КРИСТОФ	мр
КРИСТОФЕР	мр
КРИСТОФОР	мр
КРИСТЬЯН	мр
КРОНИД	мр
КСАВЕРИЙ	мр
КСАВЬЕ	мр
КСАНА	жр
КСЕМОФОНТ	мр
КСЕНИА	жр
КСЕНИЯ	жр
КСЕНОФОН	мр
КСЕНОФОНД	мр
КСЕНОФОНТ	мр
КСЕНЬЯ	жр
КСЕНЯ	жр
КСЮША	жр
КУАНТАЙ	мр
КУДРАТ	мр
КУЖУГЕТ	мр
КУЗЬМА	мр
КУЗЯ	мр
КУЛИНА	жр
КУМАР	мр
КУНАЙ	мр
КУПРИЯН	мр
КУРАБЕК	мр
КУРАМБАЙ	мр
КУРАНБАЙ	мр
КУРБАЙ	мр
КУРБАН	мр
КУРБАНБАЙ	мр
КУРБАНБЕК	мр
КУРБАНГАЛЕЙ	мр
КУРБАНГАЛИ	мр
КУРБАНГАЛИЙ	мр
КУРБАНКАДИ	мр
КУРТ	мр
КУСИЕЛ	мр
КУТУС	мр
КХАЛЕД	мр
КШИШТОВ	мр
КШИШТОФ	мр
КЭТИ	жр
КЭТРИН	жр
КЭТЭЛИНА	жр
КЮЛЛИКЕ	жр
КЯМАЛ	мр
КЯМАЛЕДДИН	мр
КЯМАМ	мр
КЯМРАН	мр
КЯРИМ	мр
ЛЁВКА	мр
ЛЁВОЧКА	мр
ЛЁНЕЧКА	мр
ЛАБИБ	мр
ЛАВИНИЯ	жр
ЛАВИСА	жр
ЛАВИЯ	жр
ЛАВР	мр
ЛАВРЕНТИЙ	мр
ЛАГИН	мр
ЛАДА	жр
ЛАДИЙ	мр
ЛАДИСЛАВ	мр
ЛАДИСЛАВА	жр
ЛАДИЯ	жр
ЛАДЛЕНА	жр
ЛАДЬ	мр
ЛАЗАР	мр
ЛАЗАРИЙ	мр
ЛАЗАРИНА	жр
ЛАЗАРЬ	мр
ЛАЗИЗА	жр
ЛАЗИМ	мр
ЛАЗЫМ	мр
ЛАЙЛА	жр
ЛАЙМА	жр
ЛАЙМАНИС	мр
ЛАЙНА	жр
ЛАЙНЕ	жр
ЛАЙОШ	мр
ЛАЙС	мр
ЛАКШМИ	жр
ЛАЛА	жр
ЛАЛИТА	жр
ЛАМЗИРА	жр
ЛАМИР	мр
ЛАМИТА	жр
ЛАМПИАДА	жр
ЛАМПИЯ	жр
ЛАНА	жр
ЛАНАРА	жр
ЛАНГИНА	жр
ЛАНДА	жр
ЛАНДИНА	жр
ЛАНИ	жр
ЛАНИДА	жр
ЛАНИНА	жр
ЛАННА	жр
ЛАННЕРА	жр
ЛАОДИКА	жр
ЛАПРИСА	жр
ЛАРА	жр
ЛАРГИЙ	мр
ЛАРЕТА	жр
ЛАРЕТТА	жр
ЛАРИАДА	жр
ЛАРИАНА	жр
ЛАРИАННА	жр
ЛАРИКА	жр
ЛАРИОН	мр
ЛАРИСА	жр
ЛАРИСАНА	жр
ЛАРИСИЯ	жр
ЛАРИССА	жр
ЛАРИТА	жр
ЛАРИТТА	жр
ЛАРРИ	мр
ЛАРРИСА	жр
ЛАРЬЯ	жр
ЛАСЛО	мр
ЛАСЛОВ	мр
ЛАТИФ	мр
ЛАТИФА	жр
ЛАУРА	жр
ЛАУРЕНТ	мр
ЛАУРЕТТА	жр
ЛАУРИ	мр
ЛАУРИКА	жр
ЛАУРИТА	жр
ЛАУРИЯ	жр
ЛАУРО	мр
ЛАЦИС	мр
ЛАША	мр
ЛЕА	жр
ЛЕАКАДИЯ	жр
ЛЕАНА	жр
ЛЕАНДР	мр
ЛЕАНДРА	жр
ЛЕАНДРО	мр
ЛЕАНИНА	жр
ЛЕАННА	жр
ЛЕАРИНА	жр
ЛЕАРИЯ	жр
ЛЕВ	мр
ЛЁВА	мр
ЛЕВАН	мр
ЛЕВЕРИЙ	мр
ЛЕВИЙ	мр
ЛЕВКАДИЯ	жр
ЛЕВКИЙ	мр
ЛЕВКИЯ	жр
ЛЕВКО	мр
ЛЕВОН	мр
ЛЕВОНТИЙ	мр
ЛЕВОНТИНА	жр
ЛЕЙДА	жр
ЛЕЙЛА	жр
ЛЕЙЛАНА	жр
ЛЕЙЯ	жр
ЛЕКА	жр
ЛЕКАДИЯ	жр
ЛЕКАНИДА	жр
ЛЕКОНИДА	жр
ЛЕЛА	жр
ЛЕЛИЯ	жр
ЛЕЛЬКА	жр
ЛЕЛЯ	жр
ЛЕЛЯНА	жр
ЛЕМБИТ	мр
ЛЕМИРА	жр
ЛЕНА	жр
ЛЕНАР	мр
ЛЕНАРА	жр
ЛЕНАРИЙ	мр
ЛЕНГИНА	жр
ЛЕНИАДА	жр
ЛЕНИАЛЛА	жр
ЛЕНИАНА	жр
ЛЕНИАРА	жр
ЛЕНИНИАДА	жр
ЛЕНИНИДА	жр
ЛЕНИНИНА	жр
ЛЕНИСЛАВ	мр
ЛЕНИЯРА	жр
ЛЕНКА	жр
ЛЕНКЕ	жр
ЛЕННАРТ	мр
ЛЕНОИДА	жр
ЛЕНОЧКА	жр
ЛЕНЬКА	мр
ЛЁНЯ	мр
ЛЕО	мр
ЛЕОКАДИЯ	жр
ЛЕОН	мр
ЛЕОНА	жр
ЛЕОНАДА	жр
ЛЕОНАДИЯ	жр
ЛЕОНАРА	жр
ЛЕОНАРД	мр
ЛЕОНАРДА	жр
ЛЕОНАРДИЙ	мр
ЛЕОНАРДО	мр
ЛЕОНАС	мр
ЛЕОНИД	мр
ЛЕОНИДА	жр
ЛЕОНИДИЯ	жр
ЛЕОНИЛА	жр
ЛЕОНИЛЛА	жр
ЛЕОНИТИЙ	мр
ЛЕОНИЯ	жр
ЛЕОННА	жр
ЛЕОНОРА	жр
ЛЕОНОРИЯ	жр
ЛЕОНС	мр
ЛЕОНСИЯ	жр
ЛЕОНТИЙ	мр
ЛЕОНТИНА	жр
ЛЕОНТИЯ	жр
ЛЕОПОЛЬД	мр
ЛЕОПОЛЬДА	жр
ЛЕОПОЛЬДИНА	жр
ЛЕОРИНА	жр
ЛЕОРИТА	жр
ЛЕПЕСТИНА	жр
ЛЕПЕСТИНИЯ	жр
ЛЕПЕСТИНЬЯ	жр
ЛЕРА	жр
ЛЕРИ	мр
ЛЕСБИЯ	жр
ЛЕСГАФТ	мр
ЛЕСЛАВ	мр
ЛЕСЯ	жр
ЛЕТИЦИЯ	жр
ЛЕХ	мр
ЛЁША	мр
ЛЕШЕК	мр
ЛЕШИК	мр
ЛИ	мр
ЛИА	жр
ЛИАЛА	жр
ЛИАЛИНА	жр
ЛИАНЕЛЛА	жр
ЛИАНИДА	жр
ЛИАННА	жр
ЛИАНОРА	жр
ЛИБЕРТИНА	жр
ЛИВ	жр
ЛИВАНА	жр
ЛИВАНТИНА	жр
ЛИВДИЯ	жр
ЛИВЕНТИНА	жр
ЛИВЕРИЙ	мр
ЛИВИАНА	жр
ЛИВОН	мр
ЛИДА	жр
ЛИДАИДА	жр
ЛИДИА	жр
ЛИДИЙ	мр
ЛИДИЯ	жр
ЛИДМИЛА	жр
ЛИДМИЯ	жр
ЛИДОЧКА	жр
ЛИЗ	жр
ЛИЗА	жр
ЛИЗАВЕТА	жр
ЛИЗАИДА	жр
ЛИЗИ	жр
ЛИЗИЯ	жр
ЛИЗОВЕТА	жр
ЛИИ	жр
ЛИИНА	жр
ЛИИЯ	жр
ЛИКА	жр
ЛИКАНДР	мр
ЛИКАНИДА	жр
ЛИКЕРИЯ	жр
ЛИКЕРЬЯ	жр
ЛИКИЯ	жр
ЛИКОНИДА	жр
ЛИКУРГ	мр
ЛИЛА	жр
ЛИЛИ	жр
ЛИЛИАН	жр
ЛИЛИАНА	жр
ЛИЛИАННА	жр
ЛИЛИНА	жр
ЛИЛИОНА	жр
ЛИЛИТА	жр
ЛИЛИТТА	жр
ЛИЛИЯ	жр
ЛИЛИЯНА	жр
ЛИЛИЯННА	жр
ЛИЛЛА	жр
ЛИЛЛИАНА	жр
ЛИЛЛИЯ	жр
ЛИЛЛЯ	жр
ЛИЛЬКА	жр
ЛИЛЯ	жр
ЛИЛЯНА	жр
ЛИМАРА	жр
ЛИМПИАДА	жр
ЛИНА	жр
ЛИНАИДА	жр
ЛИНАР	мр
ЛИНАРА	жр
ЛИНАРД	мр
ЛИНАРИЙ	мр
ЛИНАРИЯ	жр
ЛИНДА	жр
ЛИНДИЯ	жр
ЛИНДОН	мр
ЛИНИАНА	жр
ЛИНИАННА	жр
ЛИНИЗА	жр
ЛИНИНА	жр
ЛИНИРА	жр
ЛИНН	жр
ЛИННА	жр
ЛИНОИДА	жр
ЛИНОР	жр
ЛИНОРА	жр
ЛИНУРА	жр
ЛИОКАДИЯ	жр
ЛИОКАРДИЯ	жр
ЛИОН	мр
ЛИОНА	жр
ЛИОНАРДА	жр
ЛИОНЕЛЛА	жр
ЛИОНИДА	жр
ЛИОНОРА	жр
ЛИОНТИЙ	мр
ЛИОНТИНА	жр
ЛИОНЭЛЛА	жр
ЛИОР	мр
ЛИОРА	жр
ЛИПАИДА	жр
ЛИРАИДА	жр
ЛИРИНА	жр
ЛИРИСА	жр
ЛИРИЯ	жр
ЛИРУНА	жр
ЛИСИЦИАН	мр
ЛИТА	жр
ЛИЯ	жр
ЛОГВИН	мр
ЛОГМАН	мр
ЛОИДА	жр
ЛОЙОШ	мр
ЛОКАДИЯ	жр
ЛОЛА	жр
ЛОЛИАНА	жр
ЛОЛИНА	жр
ЛОЛИТА	жр
ЛОЛИТТА	жр
ЛОЛИЯ	жр
ЛОЛЛА	жр
ЛОЛЛИТА	жр
ЛОНА	жр
ЛОНГИН	мр
ЛОНДА	жр
ЛОРА	жр
ЛОРАН	жр
ЛОРАНД	мр
ЛОРЕЙДА	жр
ЛОРЕЛЕЯ	жр
ЛОРЕНА	жр
ЛОРЕТА	жр
ЛОРЕТТА	жр
ЛОРИАНА	жр
ЛОРИАННА	жр
ЛОРИДА	жр
ЛОРИНА	жр
ЛОРИСА	жр
ЛОРИТА	жр
ЛОРИТТА	жр
ЛОРИЯ	жр
ЛОРНА	жр
ЛОТФИ	мр
ЛУДВИГ	мр
ЛУДЦИЯ	жр
ЛУИ	мр
ЛУИДА	жр
ЛУИДЖИ	мр
ЛУИЗ	мр
ЛУИЗА	жр
ЛУИС	мр
ЛУИСА	жр
ЛУКА	мр
ЛУКАС	мр
ЛУКАШ	мр
ЛУКЕРИЯ	жр
ЛУКЕРЬЯ	жр
ЛУКИАН	мр
ЛУКИЯ	жр
ЛУКРЕЦИЯ	жр
ЛУКЬЯН	мр
ЛУКЬЯНА	жр
ЛУСИНА	жр
ЛУСИНЕ	жр
ЛУСИНЭ	жр
ЛУТФЕЙ	мр
ЛУТФИЙ	мр
ЛУТФУЛЛА	мр
ЛУЦИЯ	жр
ЛЮБА	жр
ЛЮБАВА	жр
ЛЮБАМИР	мр
ЛЮБАМИРА	жр
ЛЮБАША	жр
ЛЮБИНА	жр
ЛЮБОВ	жр
ЛЮБОВА	жр
ЛЮБОВЕТА	жр
ЛЮБОВИЯ	жр
ЛЮБОВЬ	жр
ЛЮБОМИЛА	жр
ЛЮБОМИР	мр
ЛЮБОМИРА	жр
ЛЮБОМЫР	мр
ЛЮБОСЛАВ	мр
ЛЮБОЧКА	жр
ЛЮДА	жр
ЛЮДВИГ	мр
ЛЮДВИГА	жр
ЛЮДВИК	мр
ЛЮДВИКА	жр
ЛЮДВИНА	жр
ЛЮДКА	жр
ЛЮДМИЛА	жр
ЛЮДМИЛАНА	жр
ЛЮДМИЛЛА	жр
ЛЮДОВИК	мр
ЛЮДОЧКА	жр
ЛЮЗА	жр
ЛЮЗИЯ	жр
ЛЮЗЯ	жр
ЛЮКАДИЯ	жр
ЛЮМАН	мр
ЛЮНГИНА	жр
ЛЮРИЙ	мр
ЛЮСЕНЕ	жр
ЛЮСИАН	мр
ЛЮСИАНА	жр
ЛЮСИК	мр
ЛЮСИЯ	жр
ЛЮССИЯ	жр
ЛЮСТИНА	жр
ЛЮСЬЕН	мр
ЛЮСЬЕНА	жр
ЛЮСЬЕТА	жр
ЛЮСЬЯНА	жр
ЛЮСЯ	жр
ЛЮСЯНА	жр
ЛЮЦИАН	мр
ЛЮЦИЛЛА	жр
ЛЮЦИНИЯ	жр
ЛЮЦИЯ	жр
ЛЯВИЗЯ	жр
ЛЯДМИЛА	жр
ЛЯЗАТ	мр
ЛЯЗИЗА	жр
ЛЯИЛЯ	жр
ЛЯЙЛА	жр
ЛЯЙЛЯ	жр
ЛЯЙСАН	мр
ЛЯЙСИРА	жр
ЛЯЙЯ	жр
ЛЯЛА	жр
ЛЯНА	жр
ЛЯТИФА	жр
ЛЯТИФЕ	жр
ЛЯЮЗА	жр
МААРИКА	жр
МАВАЗИНА	жр
МАВГИДА	жр
МАВЗУДИН	мр
МАВЗУНА	жр
МАВИЙ	мр
МАВЛИДА	жр
МАВЛОНАЗАР	мр
МАВЛУДИН	мр
МАВЛЮДА	жр
МАВЛЮДИН	мр
МАВЛЮТДИН	мр
МАВЛЯВИЙ	мр
МАВРА	жр
МАВРИНА	жр
МАВРИЯ	жр
МАВСИЛЯ	жр
МАГАМЕД	мр
МАГАМЕДАЛИ	мр
МАГАМЕДГАДЖИ	мр
МАГАМЕДЗАГИД	мр
МАГАМЕДРАСУЛ	мр
МАГАМЕДШАФИ	мр
МАГАМЕТ	мр
МАГАММАД	мр
МАГАММЕД	мр
МАГАНОВИЙ	мр
МАГАФУР	мр
МАГДА	жр
МАГДАЛЕНА	жр
МАГДАЛИНА	жр
МАГДАНА	жр
МАГДАНИЯ	жр
МАГДЕЛЕНА	жр
МАГДИ	мр
МАГДОЛИНА	жр
МАГЕРА	жр
МАГЕРАМ	мр
МАГЗУТ	мр
МАГИД	мр
МАГИНЮР	мр
МАГОМАЙ	мр
МАГОМЕД	мр
МАГОМЕДАЛИ	мр
МАГОМЕДАЛЫ	мр
МАГОМЕДАМИН	мр
МАГОМЕДБЕГ	мр
МАГОМЕДБЕК	мр
МАГОМЕДГАБИБ	мр
МАГОМЕДГАДЖИ	мр
МАГОМЕДГАЗИ	мр
МАГОМЕДЗАГИР	мр
МАГОМЕДЗАКИР	мр
МАГОМЕДКЕРИМ	мр
МАГОМЕДМУРАД	мр
МАГОМЕДМУРАТ	мр
МАГОМЕДНАБИ	мр
МАГОМЕДРАГИМ	мр
МАГОМЕДРАСУЛ	мр
МАГОМЕДСАИД	мр
МАГОМЕДСУЛТАН	мр
МАГОМЕДТАГИР	мр
МАГОМЕДХАБИБ	мр
МАГОМЕДХАН	мр
МАГОМЕДШАРИП	мр
МАГОМЕДЭМИН	мр
МАГОМЕТ	мр
МАГОМЕТХАН	мр
МАГРЕНА	жр
МАГСУМ	мр
МАДАД	мр
МАДЕЙ	мр
МАДЖАД	мр
МАДЖД	мр
МАДЖЕД	мр
МАДЖЕТ	мр
МАДЖИ	мр
МАДЖИД	мр
МАДЖИР	мр
МАДЖИТ	мр
МАДЖУДА	мр
МАДИНА	жр
МАДИС	мр
МАДЛЕН	жр
МАДЛЕНА	жр
МАЕР	мр
МАЖИТ	мр
МАЗИТ	мр
МАЗИЯ	мр
МАИНА	жр
МАИР	мр
МАИРА	жр
МАИРАМ	мр
МАЙАН	мр
МАЙЕР	мр
МАЙК	мр
МАЙКЛ	мр
МАЙЛЗ	мр
МАЙМУНА	жр
МАЙМУНАТ	жр
МАЙНОР	мр
МАЙРАМ	жр
МАЙСАРА	жр
МАЙСАРАТ	мр
МАЙСУР	мр
МАЙТ	мр
МАЙТА	жр
МАЙТИФА	жр
МАЙЯ	жр
МАКАР	мр
МАКАРИЙ	мр
МАКВЕЛ	мр
МАКРУН	мр
МАКС	мр
МАКСАТ	мр
МАКСИМ	мр
МАКСИМИАН	мр
МАКСИМИЛИАН	мр
МАКСИМИЛИАНА	жр
МАКСИМИЛЬЯН	мр
МАКСУД	мр
МАКСУЗ	мр
МАКСУТ	мр
МАЛАНИЯ	жр
МАЛАНКА	жр
МАЛАНЬЯ	жр
МАЛВИНА	жр
МАЛГОЖАТА	жр
МАЛЕЙ	мр
МАЛИК	мр
МАЛИКА	жр
МАЛИЯ	жр
МАЛЬВИНА	жр
МАЛЬВИРА	жр
МАЛЮТА	мр
МАМАЙ	мр
МАМЕД	мр
МАМИКАН	мр
МАМИКОН	мр
МАМУКА	мр
МАНАНА	жр
МАНАРША	жр
МАНВЕЛ	мр
МАНЕФА	жр
МАНИВАЛЬД	мр
МАНИРА	жр
МАННАН	мр
МАННАФ	мр
МАНОЛА	жр
МАНСУР	мр
МАНУИЛ	мр
МАНУРА	жр
МАНУЭЛ	мр
МАНУЭЛА	жр
МАНУЭЛЛА	жр
МАНУЭЛЬ	жр
МАНЬКА	жр
МАНЯ	жр
МАО	мр
МАРАТ	мр
МАРГАГИТА	жр
МАРГАЛИНА	жр
МАРГАРЕТА	жр
МАРГАРИНТА	жр
МАРГАРИТА	жр
МАРГИТА	жр
МАРГОС	жр
МАРГОТ	жр
МАРГОША	жр
МАРГРЕТА	жр
МАРГРИТА	жр
МАРГУС	мр
МАРГУТ	мр
МАРГУШ	мр
МАРГУША	жр
МАРГШАРИТА	жр
МАРДАРИЙ	мр
МАРЕК	мр
МАРЕМИЯ	жр
МАРЕМЬЯНА	жр
МАРЕНИКА	жр
МАРЕТА	жр
МАРЕТТА	жр
МАРЗАГИТ	мр
МАРЗИЯ	жр
МАРИА	жр
МАРИАДА	жр
МАРИАЛЕНА	жр
МАРИАМИЯ	жр
МАРИАМНА	жр
МАРИАН	жр
МАРИАНА	жр
МАРИАННА	жр
МАРИДА	жр
МАРИЕТТА	жр
МАРИК	мр
МАРИКА	жр
МАРИКЕ	жр
МАРИКО	мр
МАРИМЬЯНА	жр
МАРИМЯНА	жр
МАРИН	мр
МАРИНА	жр
МАРИНЕЛА	жр
МАРИНЕЛЛА	жр
МАРИНЕТА	жр
МАРИНЕТТА	жр
МАРИНИКА	жр
МАРИННА	жр
МАРИНЭЛЛА	жр
МАРИО	мр
МАРИОЛА	жр
МАРИОЛЛА	жр
МАРИОНА	жр
МАРИОНЕЛА	жр
МАРИОНЕЛЛА	жр
МАРИОНЕТТА	жр
МАРИОНИЛА	жр
МАРИОНИЛЛА	жр
МАРИОННА	жр
МАРИОНЭЛЛА	жр
МАРИСА	жр
МАРИСТА	жр
МАРИСЯ	жр
МАРИТА	жр
МАРИТАНА	жр
МАРИТАННА	жр
МАРИТЕ	жр
МАРИТТА	мр
МАРИТЭ	жр
МАРИТЯ	жр
МАРИУЛА	жр
МАРИФАТ	мр
МАРИЦА	жр
МАРИЧИКА	жр
МАРИЧКА	жр
МАРИЭМ	жр
МАРИЭТА	жр
МАРИЭТТА	жр
МАРИЯ	жр
МАРИЯН	мр
МАРИЯНА	жр
МАРИЯННА	жр
МАРИЯТИНА	жр
МАРК	мр
МАРКЕЛ	мр
МАРКЕЛЛА	жр
МАРКЕТА	жр
МАРКИТА	жр
МАРКИЯН	мр
МАРКО	мр
МАРКОС	мр
МАРКСЕНА	жр
МАРКСИНА	жр
МАРКУ	мр
МАРКУС	мр
МАРКУЦА	жр
МАРЛЕН	мр
МАРЛЕНА	жр
МАРОСЛАВА	жр
МАРС	мр
МАРСЕЛ	мр
МАРСЕЛА	жр
МАРСЕЛИНА	жр
МАРСЕЛЬ	мр
МАРТА	жр
МАРТАЗА	жр
МАРТАМ	мр
МАРТАН	мр
МАРТЕМЬЯН	мр
МАРТЕНА	жр
МАРТЕРИЙ	мр
МАРТИ	мр
МАРТИК	мр
МАРТИМ	мр
МАРТИМЬЯН	мр
МАРТИН	мр
МАРТИНАС	мр
МАРТИНЕС	мр
МАРТИНОС	мр
МАРТИНУС	мр
МАРТИНЬ	жр
МАРТИР	мр
МАРТИРИЙ	мр
МАРТИРОС	мр
МАРТИЯН	мр
МАРТКО	мр
МАРТО	мр
МАРТОН	мр
МАРТОХА	жр
МАРТУЗ	мр
МАРТУН	мр
МАРТУНИК	мр
МАРТУША	жр
МАРТЫН	мр
МАРТЬЯН	мр
МАРТЯН	мр
МАРУС	мр
МАРУСЯ	жр
МАРФА	жр
МАРФУША	жр
МАРХАБА	мр
МАРЦЕЛИНА	жр
МАРЦИАННА	жр
МАРЦИЛИНА	жр
МАРЧЕЛА	жр
МАРЧЕЛЛА	жр
МАРЫСЯ	жр
МАРЬЯ	жр
МАРЬЯМ	жр
МАРЬЯМА	жр
МАРЬЯМБАНУ	жр
МАРЬЯН	жр
МАРЬЯНА	жр
МАРЬЯННА	жр
МАРЭК	мр
МАРЯН	мр
МАСЛАВЕЙ	мр
МАСНАВИ	мр
МАСТРАДИЯ	жр
МАСТРИДА	жр
МАСТРИДИЯ	жр
МАСТУРА	жр
МАСЯНЯ	жр
МАТАНАТ	мр
МАТВЕЙ	мр
МАТЕУШ	мр
МАТИЛЬДА	жр
МАТКАРИМ	мр
МАТРЕНА	жр
МАТРУНА	жр
МАТРЯНА	жр
МАТТИ	мр
МАТФЕЙ	мр
МАФТУН	мр
МАХАМЕД	мр
МАХАМЕДЖАН	мр
МАХАМЕТ	мр
МАХАММАД	мр
МАХАММАДЖАН	мр
МАХАММАДЖОН	мр
МАХАММАТ	мр
МАХАММЕД	мр
МАХАР	мр
МАХАРРАМ	жр
МАХЕР	мр
МАХИР	мр
МАХИРА	жр
МАХМАДИ	мр
МАХМАДРУЗИ	мр
МАХМАДУЛА	мр
МАХМАДШУКУР	мр
МАХМУД	мр
МАХМУДЖАН	мр
МАХМУДЖОН	мр
МАХМУТ	мр
МАХМУТЖАН	мр
МАХМУТЖОН	мр
МАХОМАД	мр
МАХОМЕД	мр
МАХОММАД	мр
МАХСУД	мр
МАХСУТ	мр
МАЧЕЙ	мр
МАША	жр
МАШЕНЬКА	жр
МАЭЛЬ	мр
МАЯНА	жр
МГЕР	мр
МЕДЕЯ	жр
МЕДЖИД	мр
МЕЕЛИС	мр
МЕЛАНИЯ	жр
МЕЛАНЬЯ	жр
МЕЛЕНТИЙ	мр
МЕЛЕТИЙ	мр
МЕЛИК	мр
МЕЛИТА	жр
МЕЛИТИНА	жр
МЕЛИТОН	мр
МЕЛИТОС	мр
МЕЛИТРИСА	жр
МЕЛЬПОМЕНА	жр
МЕЛЬХИОР	мр
МЕРГЕН	мр
МЕРИ	жр
МЕРИЛ	жр
МЕРИНЭ	жр
МЕРКУЛ	мр
МЕРУДЖАН	мр
МЕРУЖАН	мр
МЕРУМАН	мр
МЕРУТАН	мр
МЕРУШАН	мр
МЕРЬЕМ	жр
МЕСРОП	мр
МЕТАЛИНА	жр
МЕТАЛЛИНА	жр
МЕТИСЛАВ	мр
МЕТИСЛАВА	жр
МЕТОДИ	мр
МЕТОДИЙ	мр
МЕТОДИЯ	жр
МЕТТЬЮ	мр
МЕФИСТОФЕЛЬ	мр
МЕФОДИ	мр
МЕФОДИЙ	мр
МЕХАЛИНА	жр
МЕХМАН	мр
МЕХМЕД	мр
МЕХМЕТ	мр
МЕХТИ	мр
МЕЧЕСЛАВ	мр
МЕЧЕСЛАВА	жр
МЕЧИСЛАВ	мр
МЕЧИСЛАВА	жр
МЗИЯ	жр
МИА	жр
МИАССАР	мр
МИДХАД	мр
МИК	мр
МИКАЕЛ	мр
МИКАИЛЬ	мр
МИКАЭЛ	мр
МИКАЭЛЬ	мр
МИКЛОШ	мр
МИКОЛА	мр
МИКОЛАЙ	мр
МИКУЛАШ	мр
МИКУТА	жр
МИЛА	жр
МИЛАНДА	жр
МИЛАНИЯ	жр
МИЛАНКА	жр
МИЛАННА	жр
МИЛАНО	мр
МИЛАНТИЙ	мр
МИЛАНТИНА	жр
МИЛАНЬЯ	жр
МИЛАНЯ	жр
МИЛАУША	мр
МИЛЕНА	жр
МИЛЕНТИНА	жр
МИЛЕТА	жр
МИЛЕТИНА	жр
МИЛЕТТА	жр
МИЛИЙ	мр
МИЛИНТИНА	жр
МИЛИСА	жр
МИЛИССА	жр
МИЛИСТИНА	жр
МИЛИТИНА	жр
МИЛИЦА	жр
МИЛИЯ	жр
МИЛЛИЯ	жр
МИЛО	мр
МИЛОДОРА	жр
МИЛОНА	жр
МИЛОРАД	мр
МИЛОСЛАВ	мр
МИЛОСЛАВА	жр
МИЛТОН	мр
МИЛЬВАРА	жр
МИЛЬГРАМ	мр
МИМИ	жр
МИНАБУТДИН	мр
МИНАДОРА	жр
МИНАЙ	мр
МИНГ	мр
МИНГАЛЕЙ	мр
МИНГАЛИЙ	мр
МИНИГУЛЬ	жр
МИННИРАИС	мр
МИННУЛА	мр
МИНОДОРА	жр
МИНРЯ	жр
МИНТИМЕР	мр
МИНЬ	жр
МИНЬКА	мр
МИРАБ	мр
МИРАБЕЛЛА	жр
МИРАЛЬДА	жр
МИРАН	мр
МИРАНДА	жр
МИРАНИЯ	жр
МИРГАЯЗ	мр
МИРЗА	мр
МИРИАМ	жр
МИРИЯ	жр
МИРЛАН	мр
МИРОИДА	жр
МИРОЛЬДА	жр
МИРОЛЮБ	мр
МИРОЛЮБА	жр
МИРОН	мр
МИРОНИХА	жр
МИРОНИЯ	жр
МИРОПИЯ	жр
МИРОСЛАВ	мр
МИРОСЛАВА	жр
МИРОСЛАВНА	жр
МИРФАТЫХ	мр
МИРХАЙДАР	мр
МИРЧА	мр
МИРЬЕМ	жр
МИРЬЯМ	жр
МИРЬЯН	мр
МИСАК	мр
МИТАЛИНА	жр
МИТЕНЬКА	мр
МИТРОФАН	мр
МИТЬКА	мр
МИТЯ	мр
МИФТАХ	мр
МИХАИЛ	мр
МИХАИЛИНА	жр
МИХАЙЛ	мр
МИХАЙЛИНА	жр
МИХАЙЛО	мр
МИХАЛ	мр
МИХАЛИНА	жр
МИХАМЛ	мр
МИХАЭЛЬ	мр
МИХЕЙ	мр
МИХКЕЛЬ	мр
МИЧЕСЛАВ	мр
МИЧИСЛАВ	мр
МИЧИСЛАВА	жр
МИША	мр
МИШЕЛЬ	мр-жр
МИШЕНЬКА	мр
МИЯ	жр
МИЯСЯ	жр
МКРТИЧ	мр
МКРТЫЧ	мр
МЛАДА	жр
МНАВАРА	жр
МОДЕСТ	мр
МОИСЕЙ	мр
МОЙСЕЙ	мр
МОЙША	мр
МОКАДИЯ	жр
МОКЕЙ	мр
МОКРИНА	жр
МОЛДАБАЙ	мр
МОЛДАГАЗЫ	мр
МОНА	жр
МОНИКА	жр
МОНСЕРРАТ	мр
МОРА	жр
МОРАН	жр
МОРГУНИХА	жр
МОРДЕХАЙ	мр
МОРИС	мр
МОТА	мр
МОТЯ	жр
МОХАМАД	мр
МОХАМЕД	мр
МОХАМЕДАЛИ	мр
МОХАММАД	мр
МОХАММАДАЛИ	мр
МОХАММАДРЕЗА	мр
МОХАММЕД	мр
МОХД	мр
МОШЕ	мр
МСТИСЛАВ	мр
МУАМАР	мр
МУБАРИЗ	мр
МУБАРИК	мр
МУБАРИС	мр
МУБАРЯК	мр
МУДДАРИС	мр
МУДИТЕ	жр
МУЗАГИДАН	мр
МУЗАФФАР	мр
МУЗАФФАРЖАН	мр
МУЗАФФЕР	мр
МУЗАФФОР	мр
МУЗОЧКА	жр
МУККАРАМ	мр
МУКТАДА	мр
МУЛАВИ	мр
МУЛЛАГАЛИ	мр
МУНАВАРА	жр
МУНАЗДАГА	мр
МУНАРА	жр
МУНИР	мр
МУНИС	мр
МУРАД	мр
МУРАЗ	мр
МУРАТ	мр
МУРЗА	мр
МУРСАЛ	мр
МУРТАЗА	мр
МУРТУЗАЛИ	мр
МУРШИДЯ	мр
МУСА	мр-жр
МУСАГИТДИН	мр
МУСАЙ	мр
МУСЛИМ	мр
МУССА	мр
МУСТАФА	мр
МУСТАФАКУЛ	мр
МУСЬКА	жр
МУСЯ	жр
МУТАЛЛАП	мр
МУХАМАД	мр
МУХАМЕД	мр
МУХАМЕДДИН	мр
МУХАМЕДЬЯР	мр
МУХАМЕТ	мр
МУХАММАД	мр
МУХАММАТ	мр
МУХАММЕД	мр
МУХАММЕТМУРАТ	мр
МУХАРБЕК	мр
МУХАРБИ	мр
МУХИТДИН	мр
МУХЛИСА	жр
МУХМАД	мр
МУХТАР	мр
МУШЕГ	мр
МХИТАР	мр
МЭННИ	мр
МЭРИ	жр
МЭРИЛИН	жр
МЭТЬЮ	мр
МЯКЗЮМ	мр
МЯЛХИ	жр
МЯРТ	мр
МЯЧЕСЛАВ	мр
МЯЧЕСЛАВА	жр
МЯЧИСЛАВ	мр
НААЛА	жр
НАБИ	мр
НАБИЯ	жр
НАВИД	мр
НАГИМА	жр
НАДАР	мр
НАДЕЖДА	жр
НАДЖАФ	мр
НАДЖИ	мр
НАДЖИБ	мр
НАДИМ	мр
НАДИМА	жр
НАДИМЕ	жр
НАДИМЯ	жр
НАДИР	мр
НАДИЯ	жр
НАДЫЯ	жр
НАДЬКА	жр
НАДЮША	жр
НАДЯ	жр
НАЖИЯ	жр
НАЖМИДДИН	мр
НАЖМИДИН	мр
НАЖМУДДИН	мр
НАЖМУДИН	мр
НАЖМУТДИН	мр
НАЗАР	мр
НАЗАРБЕК	мр
НАЗАРИЙ	мр
НАЗАРИЯ	жр
НАЗГУЛЬ	жр
НАЗЕРА	мр
НАЗИГУЛЬ	жр
НАЗИМ	мр
НАЗИП	мр
НАЗИР	мр
НАЗИРА	жр
НАЗИФ	мр
НАЗИФЕ	жр
НАЗИЯ	жр
НАИБА	жр
НАИДА	жр
НАИЛ	мр
НАИЛА	жр
НАИЛЬ	мр
НАИЛЯ	жр
НАИНА	жр
НАИННА	жр
НАИРА	жр
НАИСА	жр
НАИТАЛЬЯ	жр
НАЙДА	жр
НАЛАЛИЯ	жр
НАЛАЛЬЯ	жр
НАЛАТИЯ	жр
НАЛИЧ	мр
НАЛИЯ	жр
НАМАЛЬЯ	жр
НАМДАК	мр
НАМИГ	мр
НАМИЗАД	мр
НАМИК	мр
НАНА	жр
НАНЭ	жр
НАНЯ	жр
НАОМИ	жр
НАОНИЛА	жр
НАПАЛЕОН	мр
НАРАН	мр
НАРГИЗ	мр
НАРГИЗА	жр
НАРГИЛА	жр
НАРГИЛЯ	жр
НАРГИСА	жр
НАРИЙ	мр
НАРИК	мр
НАРИМ	мр
НАРИМА	жр
НАРИМАН	мр
НАРИМОН	мр
НАРИНЕ	жр
НАРКИС	мр
НАСИМА	жр
НАСИР	мр
НАСИРАДДИН	мр
НАСИХ	мр
НАСРЕТДИН	мр
НАСРУЛЛА	мр
НАСРУТДИН	мр
НАСТАЗИЯ	жр
НАСТАС	мр
НАСТАСИЯ	жр
НАСТАССЯ	жр
НАСТАСЬЯ	жр
НАСТЯ	жр
НАТАЛИ	жр
НАТАЛИА	жр
НАТАЛИНА	жр
НАТАЛИСА	жр
НАТАЛИЯ	жр
НАТАЛИЯНА	жр
НАТАЛКА	жр
НАТАЛЬЯ	жр
НАТАЛЯ	жр
НАТАН	мр
НАТАНИЯ	жр
НАТАША	жр
НАТАЭЛЛА	жр
НАТЕЛА	жр
НАТЕЛИЯ	жр
НАТЕЛЛА	жр
НАТИК	мр
НАТЭЛЛА	жр
НАУМ	мр
НАУР	мр
НАФИС	мр
НАФИСЯ	жр
НАХМАН	мр
НЕЛА	жр
НЕЛЕНТИНА	жр
НЕЛЕЯ	жр
НЕЛИАНА	жр
НЕЛИАННА	жр
НЕЛИДА	жр
НЕЛИДИЯ	жр
НЕЛИННА	жр
НЕЛИЯ	жр
НЕЛЛА	жр
НЕЛЛИ	жр
НЕЛЛИНА	жр
НЕЛЛИОНОРА	жр
НЕЛЛИЯ	жр
НЕЛЛЬ	жр
НЕЛЛЯ	жр
НЕЛСОН	мр
НЕЛУ	мр
НЕЛЬ	мр
НЕЛЬВИНА	жр
НЕЛЬВИРА	жр
НЕЛЬСОН	мр
НЕЛЯ	жр
НЕНИЛА	жр
НЕНСИ	жр
НЕОЛА	жр
НЕОЛИНА	жр
НЕОНЕЛА	жр
НЕОНЕЛЛА	жр
НЕОНЕЛЬ	жр
НЕОНИКА	жр
НЕОНИЛА	жр
НЕОНИЛИЯ	жр
НЕОНИЛЛА	жр
НЕОНИЛЯ	жр
НЕОННИЛА	жр
НЕОНОРА	жр
НЕРЕИДА	жр
НЕРИМАН	мр
НЕРИМАНТАС	мр
НЕРОН	мр
НЕСТЕР	мр
НЕСТОР	мр
НЕФЕД	мр
НЕФЕРТИТИ	жр
НЕФОДИЙ	мр
НЕХАМА	жр
НЕХУМА	жр
НИАЗ	мр
НИГА	жр
НИГАР	мр
НИГАРА	жр
НИГИНА	жр
НИГЯР	жр
НИЗАДИЛ	мр
НИЗАМАДДИН	мр
НИЗАМЕДДИН	мр
НИЗАМЕТДИН	мр
НИЗАМЖАН	мр
НИЗАМИДДИН	мр
НИЗАМИН	мр
НИЗАМУДДИН	мр
НИЗАМУДИН	мр
НИЗАМУТДИН	мр
НИЗАР	мр
НИКА	жр
НИКАНДР	мр
НИКАНОР	мр
НИКИТА	мр
НИКИТИЙ	мр
НИКИФОР	мр
НИКОДИМ	мр
НИКОЛАЙ	мр
НИКОЛАС	мр
НИКОЛЕТА	жр
НИКОЛЕТТА	жр
НИКОЛИНА	жр
НИКОЛЬ	жр
НИКОН	мр
НИКОРА	жр
НИКТА	жр
НИКУ	мр
НИКУЛАЙ	мр
НИЛ	мр
НИЛЛА	жр
НИЛУФАР	жр
НИЛЬС	мр
НИМФАЛИДА	жр
НИНА	жр
НИНЕЛИНА	жр
НИНЕЛИЯ	жр
НИНЕЛЛ	жр
НИНЕЛЛА	жр
НИНЕЛЛЯ	жр
НИНЕЛЬ	жр
НИНЕЛЯ	жр
НИНИА	жр
НИНКА	жр
НИНО	мр
НИНФОДОРА	жр
НИОЛА	жр
НИОЛИНА	жр
НИОНЕЛА	жр
НИОНЕЛЛА	жр
НИОНЕЛЬ	жр
НИОНИЛА	жр
НИОНИЛЛА	жр
НИОНИНА	жр
НИОНИЯ	жр
НИСИМ	мр
НИФОНТ	мр
НИЯЗ	мр
НИЯМЕДДИН	мр
НОАМ	мр
НОДАР	мр
НОЙ	мр
НОЙХ	мр
НОНИЯ	жр
НОНКА	жр
НОННА	жр
НОРБЕРТ	мр
НОРВУЗ	мр
НОРМИН	мр
НОЯБРИНА	жр
НУГЗАР	мр
НУНЕХИЯ	жр
НУР	мр
НУРАДИН	мр
НУРАНГИЗ	жр
НУРАНИЯ	жр
НУРБЕК	мр
НУРГАЙША	жр
НУРГАЛЕЙ	мр
НУРГАЛИ	мр
НУРЕТДИН	мр
НУРЗИДА	жр
НУРИАХМЕТ	мр
НУРИСЛАМ	мр
НУРИЯ	жр
НУРЛАН	мр
НУРЛАНА	жр
НУРЛЫХУДА	мр
НУРМАГАМЕД	мр
НУРМАГОМЕД	мр
НУРМАМЕД	мр
НУРМАТ	мр
НУРМУХАМЕД	мр
НУРМУХАМЕТ	мр
НУРМУХАММЕД	мр
НУРСУЛТАН	мр
НУРУЛЛА	мр
НУРУЛО	мр
НУРУТДИН	мр
НУРЫЙ	мр
НЭЛЛИНА	жр
НЭЛЛИЯ	жр
НЭЛЛЯ	жр
НЭЛЯ	жр
НЭОНИЛЛА	жр
НЮРА	жр
НЮРГУН	мр
НЮРГУСТАНА	жр
НЮРГУЯНА	жр
НЮРИФА	жр
НЮРИФЯ	жр
НЮРИЯ	жр
НЮРСЕНА	жр
НЮРУЛА	жр
НЮСЯ	жр
НЮША	жр
НЯЗЫФ	мр
ОВАКИМ	мр
ОВАНЕС	мр
ОВИДИЙ	мр
ОВИДИО	мр
ОВИК	мр
ОВНАН	мр
ОВСАНА	жр
ОВСАННА	жр
ОВСЕЙ	мр
ОГАНЕЗ	мр
ОГАНЕС	мр
ОГЛЫ	мр
ОГНЕСА	жр
ОГНЯН	мр
ОГОНЕС	мр
ОГУСТИН	мр
ОДАМБАЙ	мр
ОДАРИЯ	жр
ОДАРКА	жр
ОДЕД	мр
ОДЕЛИНА	жр
ОДЕЛИЯ	жр
ОДЕЛЛА	жр
ОДИСЕЙ	мр
ОДИССЕЙ	мр
ОДРИ	жр
ОЗАРИЙ	мр
ОЙГУЛЬ	жр
ОЙНВИД	мр
ОКСАНА	жр
ОКСАННА	жр
ОКСЕН	мр
ОКСЕНА	жр
ОКСЕНИЙ	мр
ОКСЕНИЯ	жр
ОКСЕНТИЙ	мр
ОКСИЙ	мр
ОКСИНА	жр
ОКСИНИЯ	жр
ОКТАВ	мр
ОКТАВИАН	мр
ОКТАВИЙ	мр
ОКТАВИН	мр
ОКТАВИНА	жр
ОКТАВИОН	мр
ОКТАВИЯ	жр
ОКТАВИЯН	мр
ОКТАВЬЯН	мр
ОКТАВЯН	мр
ОКТОВИАН	мр
ОКТЯБРИНА	жр
ОКУЛИНА	жр
ОЛЕВ	мр
ОЛЕВТИНА	жр
ОЛЕГ	мр
ОЛЕГИМИР	мр
ОЛЕКСАНДР	мр
ОЛЕКСАНДРА	жр
ОЛЕКСЕЙ	мр
ОЛЕКСИЙ	мр
ОЛЕНЬКА	жр
ОЛЕС	мр
ОЛЕСИЯ	жр
ОЛЕСЬ	мр
ОЛЕСЬКА	жр
ОЛЕСЬЯ	жр
ОЛЕЧКА	жр
ОЛЖАС	мр
ОЛИВЕР	мр
ОЛИВЕРА	жр
ОЛИВИЯ	жр
ОЛИВЬЯ	жр
ОЛИГА	жр
ОЛИДА	жр
ОЛИМПИДА	жр
ОЛИМПИЙ	мр
ОЛИНДА	жр
ОЛИЯ	жр
ОЛОДАР	мр
ОЛЬГА	жр
ОЛЬГЕРДА	жр
ОЛЬЯНА	жр
ОЛЭСЯ	жр
ОЛЯ	жр
ОЛЯНА	жр
ОМАЛИЯ	жр
ОМАР	мр
ОМЕЛЬЯН	мр
ОМЕЛЯН	мр
ОМЕР	мр
ОНГАРБАЙ	мр
ОНЕЛЬ	жр
ОНЕЛЯ	жр
ОНИК	мр
ОНИСИМ	мр
ОНИСИЯ	жр
ОНИСЬЯ	жр
ОНОРИНА	жр
ОНОФРИЙ	мр
ОНУФРИЙ	мр
ОПАНАС	мр
ОРАЗ	мр
ОРАЗАЛЫ	мр
ОРАЗБАЙ	мр
ОРАЗБЕРДИ	мр
ОРАЗГЕЛЬДЫ	мр
ОРАЗКЛЫЧ	мр
ОРАЗМУРАД	мр
ОРАЗМУХАМЕД	мр
ОРАКБАЙ	мр
ОРЕСТ	мр
ОРЕСТА	жр
ОРЕСТИЯ	жр
ОРИОН	мр
ОРИСЛАВА	жр
ОРИСТ	мр
ОРИСЯ	жр
ОРЛЕАНА	жр
ОРЛЕГ	мр
ОРЛЕТТА	жр
ОРУДЖ	мр
ОРФЕЙ	мр
ОРШОЯ	жр
ОРЫСЯ	жр
ОСАМА	мр
ОСВАЛЬД	мр
ОСВАЛЬДО	мр
ОСЕРБАЙ	мр
ОСИП	мр
ОСКАНА	жр
ОСКАР	мр
ОСКАРД	мр
ОСЛАН	мр
ОСМАН	мр
ОСНЕЛЬДА	жр
ОСТАП	мр
ОСТАФИЙ	мр
ОСЯ	мр
ОТАБЕК	мр
ОТАР	мр
ОТАРИ	мр
ОТАРИЙ	мр
ОТЕЛЛО	мр
ОТМАН	мр
ОТТО	мр
ОФЕЛИЯ	жр
ОФЕЛЯ	жр
ОФЕР	мр
ОФИК	мр
ПААТ	мр
ПААТА	мр
ПААТО	мр
ПАБЛИТО	мр
ПАВАН	мр
ПАВЕЛ	мр
ПАВЕЛАС	мр
ПАВИЛАС	мр
ПАВЛЕНА	жр
ПАВЛИК	мр
ПАВЛИН	мр
ПАВЛИНА	жр
ПАВЛО	мр
ПАИСИЙ	мр
ПАЙЗУТДИН	мр
ПАЙЦАР	мр
ПАЛАГЕЯ	жр
ПАЛАГИЯ	жр
ПАЛАД	мр
ПАЛАЖКА	жр
ПАЛИНАРА	жр
ПАЛИНАРИЯ	жр
ПАЛОГЕЯ	жр
ПАЛЬМИРО	мр
ПАМЕЛА	жр
ПАМФИЛ	мр
ПАНАЙОТ	мр
ПАНАС	мр
ПАНКАДЖ	мр
ПАНКРАТ	мр
ПАНКРАТИЙ	мр
ПАНТЕЙЛЕМОН	мр
ПАНТЕЛЕЙ	мр
ПАНТЕЛЕЙМОН	мр
ПАНТЕЛЕМОН	мр
ПАНТЕЛИМОН	мр
ПАНТИЛЕЙ	мр
ПАНТИЛЕЙМОН	мр
ПАНТИЛИМОН	мр
ПАНФИЛ	мр
ПАНФИЛИЙ	мр
ПАОЛО	мр
ПАРАМОН	мр
ПАРАНДЗЕМ	мр
ПАРАСКА	жр
ПАРАСКЕВА	жр
ПАРАСКЕВИЯ	жр
ПАРАСКЕЯ	жр
ПАРАСКИВА	жр
ПАРАСКОВЕЯ	жр
ПАРАСКОВИЯ	жр
ПАРАСКОВЬЯ	жр
ПАРАСКОВЯ	жр
ПАРАСЬКА	жр
ПАРВИН	мр
ПАРМЕН	мр
ПАРНИША	мр
ПАРОСКОВИЯ	жр
ПАРСИФАЛЬ	мр
ПАРТОС	мр
ПАРУИР	мр
ПАРУЙР	мр
ПАРФЕН	мр
ПАРФЕНА	жр
ПАРФЕНИЙ	мр
ПАРФЕНТИЙ	мр
ПАРФЕРИЙ	мр
ПАРФИР	мр
ПАРФИРИЙ	мр
ПАСКАЛЬ	мр
ПАТИМАТ	жр
ПАТРИК	мр
ПАТРИКЕЙ	мр
ПАТРИКИЙ	мр
ПАТРИС	мр
ПАТРИЦИЯ	жр
ПАТЫМА	жр
ПАУЛА	жр
ПАУЛИНА	жр
ПАУЛО	мр
ПАУЛЬ	мр
ПАФНУТИЙ	мр
ПАХОМ	мр
ПАХОМКА	мр
ПАХРИТДИН	мр
ПАХРУДИН	мр
ПАША	мр
ПЕВЕК	мр
ПЕДРО	мр
ПЕЕТЕР	мр
ПЕИР	мр
ПЕЛАГЕНЯ	жр
ПЕЛАГЕЯ	жр
ПЕЛАГИЯ	жр
ПЕЛАНИЯ	жр
ПЕЛАНЬЯ	жр
ПЕЛЛАГЕЯ	жр
ПЕЛОГЕЯ	жр
ПЕЛОГИЯ	жр
ПЕНЕЛОПА	жр
ПЕНТЕЛЕЙ	мр
ПЕРВЕЗ	мр
ПЕРДОВС	жр
ПЕРЕСВЕТ	мр
ПЕРСИДА	жр
ПЕРСУДА	жр
ПЕРФИЛИЙ	мр
ПЕСТЕМИЯ	жр
ПЕСТИЯ	жр
ПЕСЯ	жр
ПЕТЕР	мр
ПЕТЕРИС	мр
ПЁТР	мр
ПЕТРА	жр
ПЕТРАНА	жр
ПЕТРАС	мр
ПЕТРИК	мр
ПЕТРО	мр
ПЕТРОНЕЛЯ	жр
ПЕТРОНИЯ	жр
ПЕТРУНА	жр
ПЕТРУНЕЛИЯ	жр
ПЕТРУНЕЛЯ	жр
ПЕТРУНИЯ	жр
ПЕТРУНЬЯ	жр
ПЕТРУНЯ	жр
ПЕТРУСЯ	жр
ПЕТРУША	мр
ПЕТЬКА	мр
ПЕТЯ	мр
ПИЙ	мр
ПИЛАР	жр
ПИЛИП	мр
ПИМЕН	мр
ПИСТЕМЕЯ	жр
ПИТЕР	мр
ПИТИРИМ	мр
ПИФАГОР	мр
ПИЮС	мр
ПЛАСИДО	мр
ПЛАТОН	мр
ПЛАТОНИДА	жр
ПЛОТАНИДА	жр
ПЛОТОНИДА	жр
ПЛУТАРХ	мр
ПЛУТО	мр
ПНИНА	жр
ПОГОС	мр
ПОЛ	мр
ПОЛАГЕЯ	жр
ПОЛАД	мр
ПОЛАД-ЗАДЕ	мр
ПОЛАДА	жр
ПОЛАНЬЯ	жр
ПОЛАТ	мр
ПОЛЕКСЕНИЯ	жр
ПОЛИЕВКТ	мр
ПОЛИЕКТ	мр
ПОЛИКАРП	мр
ПОЛИКСЕНА	жр
ПОЛИКСЕНИЯ	жр
ПОЛИНА	жр
ПОЛИНАРА	жр
ПОЛИНАРИЙ	мр
ПОЛИНАРИЯ	жр
ПОЛИНАРЬЯ	жр
ПОЛИЭКТ	мр
ПОЛКАН	мр
ПОЛОГЕЯ	жр
ПОЛОГИЯ	жр
ПОЛТАРАК	мр
ПОЛЬНАРА	жр
ПОЛЯ	жр
ПОНТЕЛЕЙМОН	мр
ПОРАСКОВИЯ	жр
ПОРСОР	мр
ПОРФИЛИЙ	мр
ПОРФИРИ	мр
ПОРФИРИЙ	мр
ПОТАП	мр
ПРАКСИЯ	жр
ПРАНАС	мр
ПРАСКЕВА	жр
ПРАСКОВЕЯ	жр
ПРАСКОВИЯ	жр
ПРАСКОВЬЯ	жр
ПРАСКОВЯ	жр
ПРАСКОФЬЯ	жр
ПРЕДСЛАВА	жр
ПРИАМ	мр
ПРИСЬКА	жр
ПРОКЛ	мр
ПРОКОП	мр
ПРОКОПИЙ	мр
ПРОКОПИЯ	жр
ПРОКОФИ	мр
ПРОКОФИЙ	мр
ПРОМЕТЕЙ	мр
ПРОНЬКА	жр
ПРОСКОВИЯ	жр
ПРОСКОВЬЯ	жр
ПРОСКОФЬЯ	жр
ПРОТАС	мр
ПРОТАСИЙ	мр
ПРОХОР	мр
ПТОЛЕМЕЙ	мр
ПУЛАТ	мр
ПУЛЬФЕРИЯ	жр
ПУЛЬХЕРИЯ	жр
ПШЕМАХ	мр
ПЬЕР	мр
ПЬЕРО	мр
ПЯТР	мр
ПЯТРАС	мр
РАБАДАН	мр
РАБАЗАН	мр
РАБДАН	мр
РАБИГА	жр
РАБИХ	мр
РАВЗА	мр
РАВИДА	жр
РАВИЗА	жр
РАВИК	мр
РАВИЛ	мр
РАВИЛЬ	мр
РАВИЛЬЯ	жр
РАВИЛЯ	жр
РАВИМА	жр
РАВИНА	жр
РАВИНДЕР	мр
РАВИНДРА	жр
РАВИЯ	жр
РАВХАТ	мр
РАВШАН	мр
РАГИЛЯ	жр
РАГИМ	мр
РАГНЕДА	жр
РАГНЕТА	жр
РАДАМИР	мр
РАДАНА	жр
РАДАСЛАВ	мр
РАДВАН	мр
РАДЖ	мр
РАДЖАБ	мр
РАДЖАМАД	мр
РАДЖАН	мр
РАДЖАФ	мр
РАДЖЕБ	мр
РАДЖЕШ	мр
РАДЖЕШВАР	мр
РАДЖИВ	мр
РАДЖИНАЛЬД	мр
РАДИАДА	жр
РАДИЙ	мр
РАДИК	мр
РАДИМИР	мр
РАДИНА	жр
РАДИОН	мр
РАДИОНА	жр
РАДИСА	жр
РАДИСЛАВ	мр
РАДИСЛАВА	жр
РАДИФ	мр
РАДИФА	жр
РАДИЯ	жр
РАДМИЛА	жр
РАДМИНА	жр
РАДМИР	мр
РАДМИРА	жр
РАДНАЙ	мр
РАДОВАН	мр
РАДОМИР	мр
РАДОМИРА	жр
РАДОСЛАВ	мр
РАДОСЛАВА	жр
РАДОСЛАВНА	жр
РАДОСТИНА	жр
РАДУ	мр
РАЖА	жр
РАЖАБАЙ	мр
РАЖАББАЙ	мр
РАЖАББОЙ	мр
РАЖАБОЙ	мр
РАЗАЛИНА	жр
РАЗАЛИЯ	жр
РАЗАЛЬЯ	жр
РАЗИЛИЯ	жр
РАЗИЛЬ	мр
РАЗИЛЬЯ	жр
РАЗИЛЯ	жр
РАЗИМА	жр
РАЗИТА	жр
РАЗИФА	жр
РАЗМИК	мр
РАИД	мр
РАИДА	жр
РАИЗА	жр
РАИЛ	мр
РАИЛЬ	мр
РАИС	мр
РАИСА	жр
РАИСИЯ	жр
РАИССА	жр
РАИСЬЯ	жр
РАИФ	мр
РАИФА	жр
РАИФТА	жр
РАЙМОНД	мр
РАЙМОНДА	жр
РАЙМОНДАС	мр
РАЙМОНДС	мр
РАЙМУНД	мр
РАЙМУНДАС	мр
РАЙМУНДО	мр
РАЙНЕР	мр
РАЙНИС	мр
РАЙНОЛЬД	мр
РАЙНХАРД	мр
РАЙХАН	мр
РАЙХОН	мр-жр
РАКСАНА	жр
РАЛЕЗИЯ	жр
РАЛИ	мр
РАЛИДА	жр
РАЛИЗИЯ	жр
РАЛИНА	жр
РАЛИСА	жр
РАЛИФ	мр
РАЛИЯ	жр
РАЛЬФ	мр
РАМАЗАН	мр
РАМАЗОН	мр
РАМАНА	жр
РАМЗАН	мр
РАМЗЕС	мр
РАМЗИЯ	жр
РАМИЗ	мр
РАМИЛ	мр
РАМИЛА	жр
РАМИЛИЯ	жр
РАМИЛЛА	жр
РАМИЛЬ	мр
РАМИЛЬДА	жр
РАМИЛЯ	жр
РАМИМ	мр
РАМИН	мр
РАМИНА	жр
РАМИНАТ	мр
РАМИНТА	жр
РАМИР	мр
РАМИРЕС	мр
РАМИС	мр
РАМИХ	мр
РАМИШ	мр
РАМИЯ	жр
РАМЛЯ	жр
РАММА	жр
РАМОН	мр
РАМОНА	жр
РАМУАЛЬД	мр
РАМУАЛЬДА	жр
РАНАТ	мр
РАНЕТА	жр
РАНЕТТА	жр
РАНЗИЯ	жр
РАНИ	мр
РАНИД	мр
РАНИДА	жр
РАНИТА	жр
РАНИЯ	жр
РАННА	жр
РАСАНА	жр
РАСИД	мр
РАСИДА	жр
РАСИЛИЯ	жр
РАСИЛЬ	мр
РАСИЛЯ	жр
РАСИМ	мр
РАСИМА	жр
РАСИХ	мр
РАССИМА	жр
РАСТИСЛАВ	мр
РАСТЯМ	мр
РАСУЛ	мр
РАСУЛЬ	мр
РАСЯ	жр
РАТИБОР	мр
РАТИМА	жр
РАТИФА	жр
РАТМИР	мр
РАУАН	мр-жр
РАУЗА	жр
РАУЛ	мр
РАУЛЬ	мр
РАУФ	мр
РАУФИНА	жр
РАУХА	жр
РАУШАН	мр
РАУШАНИЯ	жр
РАФ	мр
РАФА	жр
РАФАГУТДИН	мр
РАФАДДИН	мр
РАФАЕЛ	мр
РАФАИЛ	мр
РАФАИЛА	жр
РАФАИЛЬ	мр
РАФАЙ	мр
РАФАЛИНА	жр
РАФАЛИЯ	жр
РАФАНИЯ	жр
РАФАЭЛ	мр
РАФАЭЛА	жр
РАФАЭЛЛА	жр
РАФАЭЛЬ	мр
РАФГАТ	мр
РАФИДА	жр
РАФИК	мр
РАФИЛ	мр
РАФИЛЬ	мр
РАФИМ	мр
РАФИНА	жр
РАФИНЯ	жр
РАФИРА	жр
РАФИС	мр
РАФИСА	жр
РАФИТА	жр
РАФКАТ	мр
РАХАТ	мр
РАХЕЛЬ	жр
РАХИДА	жр
РАХИЛ	мр
РАХИЛА	жр
РАХИЛИЯ	жр
РАХИЛЬ	мр
РАХИЛЬДА	жр
РАХИЛЬЯ	жр
РАХИЛЯ	жр
РАХИМ	мр
РАХИМА	жр
РАХИМБАЙ	мр
РАХИМЖАН	мр
РАХИМЬЯН	мр
РАХИМЯ	жр
РАХМАН	мр
РАХМАТ	мр
РАХМАТУЛЛА	мр
РАХМОН	мр
РАХМОНДЖОН	мр
РАХМУДДИН	мр
РАХМУДИН	мр
РАШАД	мр
РАШЕД	мр
РАШЕДЯ	жр
РАШЕЛЬ	жр
РАШИД	мр
РАШИДА	жр
РАШИТ	мр
РАЯ	жр
РЕБЕКА	жр
РЕБЕККА	жр
РЕВАЗ	мр
РЕВАЛЬ	мр
РЕВАН	мр
РЕВАС	мр
РЕВАТ	мр
РЕВВЕКА	жр
РЕВГАТ	мр
РЕВЕКА	жр
РЕВЕККА	жр
РЕВЕНКА	жр
РЕВЕТА	жр
РЕВИКА	жр
РЕВИЛИЙ	мр
РЕВИЛЬ	мр
РЕВМИРА	жр
РЕВОЛИНА	жр
РЕВОЛЬТА	жр
РЕВОМИР	мр
РЕГИНА	жр
РЕДЖЕП	мр
РЕЗА	мр
РЕЗВАН	мр
РЕЗЕДА	жр
РЕЗИДА	жр
РЕЙИМБАЙ	мр
РЕЙНА	жр
РЕЙНАЛЬДО	мр
РЕЙНАРД	мр
РЕЙНАТ	мр
РЕЙНГАРД	мр
РЕЙНГОЛЬД	мр
РЕЙНГОЛЬДТ	мр
РЕЙНО	мр
РЕЙНОЛЬД	мр
РЕЙНОЛЬДС	мр
РЕЙНХАРД	мр
РЕЙНХОЛЬД	мр
РЕЙНЯ	жр
РЕКС	мр
РЕМ	мр
РЕМИ	мр
РЕМИГИЮС	мр
РЕМИДА	жр
РЕМИЗЕ	жр
РЕМИК	мр
РЕМИН	мр
РЕМИНА	жр
РЕМИР	мр
РЕМИРА	жр
РЕМИС	мр
РЕМЛЯНА	жр
РЕММУАЛЬДА	жр
РЕМУАЛЬДА	жр
РЕНАДИЙ	мр
РЕНАИДА	жр
РЕНАРД	мр
РЕНАРТ	мр
РЕНАТ	мр
РЕНАТА	жр
РЕНАТАС	мр
РЕНАТЕ	жр
РЕНАТО	жр
РЕНАТТА	жр
РЕНГИНА	жр
РЕНЕТА	жр
РЕНЕТТА	жр
РЕННАДИЙ	мр
РЕНОЛЬД	мр
РЕОНАЛЬД	мр
РЕПСИМА	жр
РЕПСИМЕ	жр
РЕУВЕН	мр
РЕУФ	мр
РЕФ	мр
РЕФАД	мр
РЕФАТ	мр
РИАНА	жр
РИАННА	жр
РИАРИТА	жр
РИВА	жр
РИВЕКА	жр
РИВЕККА	жр
РИВХАТ	мр
РИДА	жр
РИДЖИНА	жр
РИДЖИНАЛЬД	мр
РИЗАБЕК	мр
РИЗВАН	мр
РИЗУАН	мр
РИИМА	жр
РИИНА	жр
РИК	мр
РИКА	жр
РИКО	мр
РИМА	жр
РИМАИДА	жр
РИМАНТАС	мр
РИМАС	мр
РИМВИДАС	мр
РИМЗИЛ	мр
РИМЛЯНА	жр
РИММА	жр
РИМУАЛЬДА	жр
РИНА	жр
РИНАД	мр
РИНАДА	жр
РИНАИДА	жр
РИНАТ	мр
РИНАТА	жр
РИНИТА	жр
РИОЛЕТА	жр
РИОРИТА	жр
РИПА	жр
РИППА	жр
РИПСИМИЯ	жр
РИСТО	мр
РИТА	жр
РИТАИДА	жр
РИТИНА	жр
РИФАГАТ	мр
РИФАД	мр
РИФАТ	мр
РИФКАТ	мр
РИФХАТ	мр
РИФЯН	мр
РИХАН	мр
РИХАНИ	мр
РИХАРД	мр
РИЧАРД	мр
РИШАД	мр
РИШАН	мр
РИШАР	мр
РИШАРД	мр
РИШАТ	мр
РИЯЗ	мр
РИЯН	мр
РКИЯ	мр
РОАЛЬД	мр
РОБЕН	мр
РОБЕРТ	мр
РОБЕРТА	жр
РОБЕРТАС	мр
РОБЕРТИН	мр
РОБЕРТИНА	жр
РОБЕРТИНО	мр
РОБЕРТО	мр
РОБЕСПЬЕР	мр
РОБИН	мр
РОВЕНА	жр
РОВШАН	мр
РОГНЕДА	жр
РОДЕРИК	мр
РОДЖЕНАЛЬД	мр
РОДЖЕР	мр
РОДИК	мр
РОДИОН	мр
РОДИСЛАВА	жр
РОДОЛЬФО	мр
РОДОМИР	мр
РОДОСЛАВ	мр
РОДОСЛАВА	жр
РОДЯ	мр
РОЖЕ	мр
РОЗА	жр
РОЗАИДА	жр
РОЗАИНА	жр
РОЗАЛИНА	жр
РОЗАЛИНДА	жр
РОЗАЛИЯ	жр
РОЗАЛЬДА	жр
РОЗАЛЬЯ	жр
РОЗАЛЯ	жр
РОЗАМЕЯ	жр
РОЗАМИЯ	жр
РОЗАНА	жр
РОЗАНЕТА	жр
РОЗАНИЯ	жр
РОЗАННА	жр
РОЗАНТИНА	жр
РОЗАРИЯ	жр
РОЗЕЛИНА	жр
РОЗЕЛИЯ	жр
РОЗИТА	жр
РОЗМАРИ	жр
РОЗОЛИНА	жр
РОЗОЛИЯ	жр
РОИНИ	жр
РОЙ	мр
РОКСАЛАНА	жр
РОКСАНА	жр
РОКСОЛАНА	жр
РОЛАН	мр
РОЛАНД	мр
РОЛАНДА	жр
РОЛАНДАС	мр
РОЛАНДИЙ	мр
РОЛЛАН	мр
РОЛЛАНД	мр
РОМА	мр
РОМАЗ	мр
РОМАЗАН	мр
РОМАН	мр
РОМАНА	жр
РОМАНИНА	жр
РОМАНИЯ	жр
РОМАННА	жр
РОМЕН	мр
РОМЕО	мр
РОМИК	мр
РОМИЛ	мр
РОМИНА	жр
РОМУАЛЬД	мр
РОМУАЛЬДА	жр
РОМУЛ	мр
РОМУЛЬДА	жр
РОН	мр
РОНАЛЬД	мр
РОННИ	мр
РОСАНА	жр
РОСИНА	жр
РОСЛАНА	жр
РОССИТА	жр
РОСТЕСЛАВ	мр
РОСТИК	мр
РОСТИЛАВ	мр
РОСТИСЛАВ	мр
РОСТИСЛАВА	жр
РОСТЯМ	мр
РОТИСЛАВ	мр
РОФАИНА	жр
РУБЕН	мр
РУБЕРТ	мр
РУБИН	мр
РУБИНА	жр
РУВИЛЬ	мр
РУВИМ	мр
РУВИН	мр
РУДА	жр
РУДИТА	жр
РУДОЛФ	мр
РУДОЛЬ	мр
РУДОЛЬФ	мр
РУДОЛЬФИНА	жр
РУЖАНА	жр
РУЖЕНА	жр
РУЖИНА	жр
РУЗАИНА	жр
РУЗАЛИН	жр
РУЗАЛИНА	жр
РУЗАЛИЯ	жр
РУЗАНА	жр
РУЗАННА	жр
РУЗИЛА	жр
РУЗИЛИЯ	жр
РУЗИЛЬ	мр
РУЗИЛЯ	жр
РУЗИНА	жр
РУЗИНЯ	жр
РУМИЯ	жр
РУПЕРТ	мр
РУСИФ	мр
РУСЛАМ	мр
РУСЛАН	мр
РУСЛАНА	жр
РУСЛАНБЕК	мр
РУСЛАННА	жр
РУСЛОН	мр
РУСТАМ	мр
РУСТАМБАЙ	мр
РУСТАМБЕК	мр
РУСТЕМ	мр
РУСЬКА	мр
РУТ	жр
РУТАНИЯ	жр
РУТТА	жр
РУФАН	мр
РУФАТ	мр
РУФИНА	жр
РУФИЯ	жр
РУФЬ	жр
РУШАН	мр
РУШАНА	жр
РУШАНИЯ	жр
РУШАНЬ	жр
РУШАНЬЯ	жр
РУШАНЯ	жр
РЭЙЧЕЛ	жр
РЭМ	мр
РЭМА	жр
РЭМИР	мр
РЭММ	мр
РЭНА	жр
РЮРИК	мр
РЯИС	мр
РЯНИДА	жр
РЯХИМА	жр
РЯХИМЯ	жр
СААД	мр
СААК	мр
САБИД	мр
САБИНА	жр
САБИР	мр
САБИРА	жр
САБИТ	мр
САБРИНА	жр
САБУР	мр
САВВА	мр
САВВАТЕЙ	мр
САВВАТИЙ	мр
САВВЬ	мр
САВЕЛИ	мр
САВЕЛИЙ	мр
САВИК	мр
САВОСТЬЯН	мр
САГИДА	жр
САГИТ	мр
САГЫТ	мр
САДДАМ	мр
САДЕГ	мр
САДЕХ	мр
САДРИ	мр
САДРИЯ	жр
САДРТДИН	мр
САДЫК	мр
САДЫКБЕК	мр
САЕД	мр
САЖИ	жр
САИД	мр
САИДА	жр
САИДАКРАМ	мр
САИДАЛИ	мр
САИДАХМАД	мр
САИДАХМАТ	мр
САИДАХМЕД	мр
САИДАХОН	мр
САИДБЕГ	мр
САИДИКРОМ	мр
САИДМАГОМЕД	мр
САИДМУРАД	мр
САИДМУРАТ	мр
САИДМУРОД	мр
САИДМУХАМЕД	мр
САИДНАЗАР	мр
САИДРАСУЛ	мр
САИМАН	жр
САИМЕ	жр
САИТ	мр
САЙГИДПАША	мр
САЙГИДУЛБАТАЛ	мр
САЙДАЛИМ	мр
САЙМОН	мр
САЙФУЛЛА	мр
САЙЫН	мр
САКИНА	жр
САКИТ	мр
САЛАВАЙ	мр
САЛАВАТ	мр
САЛАМШО	мр
САЛАХ	мр
САЛАХАДДИН	мр
САЛАХАДИН	мр
САЛАХИДДИН	мр
САЛАХИТДИН	мр
САЛАХУТДИН	мр
САЛЕХ	мр
САЛИЙ	мр
САЛИКДЖАН	мр
САЛИМ	мр
САЛИМА	жр
САЛИМБАЙ	мр
САЛИМБЕК	мр
САЛИХ	мр
САЛИХЬЯН	мр
САЛМАН	мр
САЛМАНИДА	жр
САЛМОНИДА	жр
САЛОМЕЯ	жр
САЛОМИЯ	жр
САЛОМОНИДА	жр
САЛОМОНИЯ	жр
САЛТАНИЯ	жр
САЛТЫЧИХА	жр
САЛЬБИЙ	мр
САЛЬВАДОР	мр
САЛЬВАТОР	мр
САЛЬВИНА	жр
САЛЬВИЯ	жр
САЛЬМИРА	жр
САЛЯХЕТДИН	мр
САМАД	мр
САМАДДИН	мр
САМАНТА	жр
САМАРИНА	жр
САМАРИЯ	жр
САМАРХАН	мр
САМАТ	мр
САМБЕЛ	мр
САМВЕЛ	мр
САМЕР	мр
САМЕРА	жр
САМИР	мр
САМИРА	жр
САМИЯ	жр
САМОЙЛА	мр
САМСОН	мр
САМУЕЛ	мр
САМУИЛ	мр
САМУЭЛ	мр
САМУЭЛЛА	жр
САМУЭЛЬ	мр
САНАБАР	жр
САНАН	мр
САНДА	жр
САНДАР	мр
САНДАХМЕД	мр
САНДЖИТ	мр
САНДИП	мр
САНДМУРАД	мр
САНДРА	жр
САНДРИНА	жр
САНДРО	мр
САНЖАЙ	мр
САНЖАР	мр
САНЖАРБЕК	мр
САНЖЕЙ	мр
САНИР	мр
САНИС	мр
САНИСЛАВ	мр
САНИТА	жр
САНИЯ	жр
САННИ	мр
САНФИРА	жр
САНЬКА	мр
САНЯ	мр
САОДАТ	жр
САПАРБАЙ	мр
САПАРБЕК	мр
САПАРМУРАД	мр
САПАРМУРАТ	мр
САПИЯТ	жр
САРА	жр
САРВАР	мр
САРГОН	мр
САРГЫЛАНА	жр
САРДААНА	жр
САРИНА	жр
САРИНГЮЛЬ	жр
САРИНЕ	жр
САРИТА	жр
САРИЯ	жр
САРКИС	мр
САРМЕН	мр
САРРА	жр
САРХАДДИН	мр
САТАНЕЙ	жр
САТИ	жр
САТИГА	жр
САТИДА	жр
САТИНА	жр
САТИЯ	жр
САТНИСЛАВ	мр
САТТАР	мр
САУД	мр
САУДА	жр
САУДАТ	мр
САУДЕ	мр
САУЛ	мр
САУЛЕМ	мр
САУНЯ	жр
САФАРБЕК	мр
САФОН	мр
САФРОН	мр
САФРОНИЙ	мр
САФТАР	мр
САФУРА	жр
САХАТМУРАД	мр
САХИБА	жр
САША	мр-жр
САЯД	мр
САЯР	мр
СВЕН	мр
СВЕТА	жр
СВЕТАЛАНА	жр
СВЕТАНА	жр
СВЕТИСЛАВ	мр
СВЕТИСЛАВА	жр
СВЕТЛАНА	жр
СВЕТЛАНГА	жр
СВЕТЛАНКА	жр
СВЕТЛОЗАР	мр
СВЕТЛОМИР	мр
СВЕТОЗАР	мр
СВЕТОЗАРА	жр
СВЕТОМИР	мр
СВЕТОСЛАВ	мр
СВЕТОСЛАВА	жр
СВИРИД	мр
СВИТЛАНА	мр
СВИТОСЛАВ	мр
СВЯТИСЛАВ	мр
СВЯТОГОР	мр
СВЯТОЗАР	мр
СВЯТОПОЛК	мр
СВЯТОСЛАВ	мр
СВЯТОСЛАВА	жр
СЕБАСТИАН	мр
СЕБАСТЬЯН	мр
СЕВА	мр-жр
СЕВАРА	жр
СЕВАСТИАН	мр
СЕВАСТЬЯН	мр
СЕВАСТЬЯНА	жр
СЕВЕНАРД	мр
СЕВЕРИНА	жр
СЕВЕРЬЯН	мр
СЕВИЛИЯ	жр
СЕВИЛЬЯНА	жр
СЕВОЧКА	мр
СЕГЕЛИЕЛЬ	мр
СЕГИЗМУНД	мр
СЕДРИК	мр
СЕИЛБЕК	мр
СЕИТ	мр
СЕИТАЛИ	мр
СЕИТХАЛИЛЬ	мр
СЕЙДАМЕТ	мр
СЕЙЕД	мр
СЕЙМУРАТ	мр
СЕЙРАН	мр
СЕЙРАНА	жр
СЕЙТ	мр
СЕЙТМУРАТ	мр
СЕЙФАДДИН	мр
СЕЙФАДИН	мр
СЕЙФЕДДИН	мр
СЕЙФЕДИН	мр
СЕЙФЕТДИН	мр
СЕЙФИДДИН	мр
СЕЙФИДИН	мр
СЕЙФУДДИН	мр
СЕЙФУТДИН	мр
СЕКЛЕТИНА	жр
СЕКЛЕТИНИЯ	жр
СЕКЛЕТИНЬЯ	жр
СЕКЛЕТИЯ	жр
СЕКЛИТИЯ	жр
СЕКРЕТИНА	жр
СЕЛЕНА	жр
СЕЛЕСТИНА	жр
СЕЛИВАН	мр
СЕЛИМХАН	мр
СЕЛИНА	жр
СЕЛИФАН	мр
СЕЛЬВЕРСТ	мр
СЕЛЬВЕСТР	мр
СЕЛЬВИНА	жр
СЕЛЬМА	жр
СЁМА	мр
СЕМЁН	мр
СЕМЕННА	жр
СЕМЕРГЕЙ	мр
СЕМИРАМИДА	жр
СЕНЕЧКА	мр
СЕНКЛЕТИЯ	жр
СЕНТЯБРИНА	жр
СЕНЬКА	мр
СЕНЯ	мр
СЕППО	мр
СЕРАФИМ	мр
СЕРАФИМА	жр
СЕРАФИМИЯ	жр
СЕРАФИНА	жр
СЕРГЕЙ	мр
СЕРГИЙ	мр
СЕРГИУС	мр
СЕРДАК	мр
СЕРДЖИУ	мр
СЕРЕЖА	мр
СЕРЖ	мр
СЕРИК	мр
СЕРИКАН	мр
СЕРИКБАЙ	мр
СЕРИККАЛИ	мр
СЕРИККАН	мр
СЕРИКПАЙ	мр
СЕРКАН	мр
СЕРОБ	мр
СЕРОЖ	мр
СЕРОЖА	мр
СЕРОЖИДДИН	мр
СЕРОЖИДИН	мр
СЕРОФИМ	мр
СЕРОФИМА	жр
СЕРХАТ	мр
СЕЧКИН	мр
СИАНА	жр
СИБАТ	мр
СИБГАТ	мр
СИБГАТУЛЛА	мр
СИБИЛЛА	жр
СИГИЗМУНД	мр
СИГИТА	жр
СИГИТАС	жр
СИГМУНД	мр
СИДОНИЯ	жр
СИДОР	мр
СИКЛИТА	жр
СИКЛИТИНА	жр
СИЛАНТИЙ	мр
СИЛЬВА	жр
СИЛЬВАНА	жр
СИЛЬВАНО	мр
СИЛЬВАРД	мр
СИЛЬВАРТ	мр
СИЛЬВЕР	мр
СИЛЬВЕРИО	мр
СИЛЬВЕРСТ	мр
СИЛЬВЕСТР	мр
СИЛЬВИЙ	мр
СИЛЬВИК	мр
СИЛЬВИНА	жр
СИЛЬВИО	мр
СИЛЬВИЯ	жр
СИЛЬВИЯН	мр
СИМА	жр
СИМЕОН	мр
СИМЗАР	мр
СИМИЗАР	мр
СИМИН	мр
СИМИОН	мр
СИМОН	мр
СИМОНА	жр
СИМОНЕТТА	жр
СИМОННА	жр
СИМОЧКА	жр
СИНАРИЙ	мр
СИНДИ	жр
СИНОРА	жр
СИНТИЯ	жр
СИРАН	мр
СИРМА	жр
СКАЙДРИТА	жр
СКАЙДРИТЕ	жр
СКОТТ	мр
СЛАВА	жр
СЛАВЕНТИЙ	мр
СЛАВИЙ	мр
СЛАВИК	мр
СЛАВИНА	жр
СЛАВИСА	жр
СЛАВИСЛАВ	мр
СЛАВИЯ	жр
СЛАВОМИР	мр
СЛАВОМИРА	жр
СЛОБОДАН	мр
СМИТ	мр
СНЕЖАНА	жр
СНЕЖАНКА	жр
СНЕЖАННА	жр
СНЕЖИНА	жр
СНИЖАНА	жр
СНИЖАННА	жр
СОЗОНТИЙ	мр
СОКРАТ	мр
СОЛОМАНДРА	жр
СОЛОМАНИДА	жр
СОЛОМАНИЯ	жр
СОЛОМЕЯ	жр
СОЛОМИЯ	жр
СОЛОМОН	мр
СОЛОМОНА	жр
СОЛОМОНИДА	жр
СОЛОМОНИЯ	жр
СОЛОНИЯ	жр
СОЛТАН	мр
СОЛЬВЕЙГ	жр
СОНДРА	жр
СОНЕЧКА	жр
СОНИЯ	жр
СОНЯ	жр
СОПА	мр
СОСЛАН	мр
СОФА	жр
СОФИКО	жр
СОФОН	мр
СОФРОН	мр
СОФРОНИЙ	мр
СОФРОНИЯ	жр
СОФФА	жр
СОФЬЯ	жр
СОЦИАЛА	жр
СОЦИАЛИНА	жр
СОЦИАЛЛА	жр
СПАРТАК	мр
СПИРИДОН	мр
СПОМЕНКА	жр
СРУЛЬ	мр
СТАВРИЙ	мр
СТАЛИНА	жр
СТАЛИНАДА	жр
СТАЛИНИДА	жр
СТАЛИНИТА	жр
СТАЛИНОСЛАВ	мр
СТАЛЛИНА	жр
СТАНИМИР	мр
СТАНИСЛАВ	мр
СТАНИСЛАВА	жр
СТАНИСЛАВАС	мр
СТАПАНИДА	жр
СТАРИСЛАВ	мр
СТАС	мр
СТАСИК	мр
СТАФАНИЯ	жр
СТАХ	мр
СТЕЛАНИДА	жр
СТЕЛИАНА	жр
СТЕЛКА	жр
СТЕЛЛА	жр
СТЕНЛИ	мр
СТЕПА	мр
СТЕПАН	мр
СТЕПАНАИДА	жр
СТЕПАНИДА	жр
СТЕПАНИЯ	жр
СТЕПАНЬЯ	жр
СТЕПАША	мр
СТЕПОНИДА	жр
СТЕФА	жр
СТЕФАН	мр
СТЕФАНА	жр
СТЕФАНИДА	жр
СТЕФАНИЙ	мр
СТЕФАНИНА	жр
СТЕФАНИЯ	жр
СТЕФАНКА	жр
СТЕША	жр
СТИВ	мр
СТИВЕН	мр
СТИЛЛИАН	мр
СТЮАРТ	мр
СУВАДЕ	жр
СУДАБА	жр
СУДАБЕ	жр
СУДИП	мр
СУЛАМИФЬ	жр
СУЛЕВ	мр
СУЛЕЙМАН	мр
СУЛИКО	мр
СУЛТАН	мр
СУЛТАНА	жр
СУЛТАНАХМАД	мр
СУЛТАНАХМЕД	мр
СУЛТАНБАЙ	мр
СУЛТАНБЕК	мр
СУЛТАНБОЙ	мр
СУЛТАНГАРАЙ	мр
СУЛТАНГАРЕЙ	мр
СУЛТАНГЕРЕЙ	мр
СУМБАТ	мр
СУНГАТУЛЛА	мр
СУРАБ	мр
СУРАБАЙ	мр
СУРАН	мр
СУРЕН	мр
СУСАНА	жр
СУСАННА	жр
СУТРИК	мр
СУХРАБ	мр
СЫЗДЫК	мр
СЫСОЙ	мр
СЭМ	мр
СЭМУЭЛЬ	мр
СЮЗАННА	жр
СЯИД	мр
ТААЛАЙБЕК	мр
ТААР	мр
ТАГАЙМУРАТ	мр
ТАГИР	мр
ТАГИРЗЯН	мр
ТАДЕЙ	мр
ТАДЕУШ	мр
ТАДЕУША	жр
ТАДЖАДДИН	мр
ТАДЖУДДИН	мр
ТАДЭУШ	мр
ТАИР	мр
ТАИРБЕК	мр
ТАИС	жр
ТАИСА	жр
ТАИСИА	жр
ТАИСИЯ	жр
ТАИСЬЯ	жр
ТАЙМАН	мр
ТАЙМУР	мр
ТАЙМУРАД	мр
ТАЙМУРАЗ	мр
ТАЙПУР	мр
ТАЙЧУБЕК	мр
ТАКАСИ	жр
ТАЛА	мр
ТАЛААТ	мр
ТАЛАБ	мр
ТАЛАБШО	мр
ТАЛАГАТ	мр
ТАЛАЙ	мр
ТАЛАЛ	мр
ТАЛАЛЬ	мр
ТАЛАНТБЕК	мр
ТАЛАП	мр
ТАЛАТ	мр
ТАЛГАТ	мр
ТАЛИП	мр
ТАЛЛА	жр
ТАЛХА	жр
ТАЛЬМИРА	жр
ТАЛЬЯНА	жр
ТАЛЯТ	мр
ТАМАЗ	мр
ТАМАРА	жр
ТАМАРКА	жр
ТАМЕРЛАН	мр
ТАМИЛА	жр
ТАМИЛИЯ	жр
ТАМИЛЛА	жр
ТАМИР	мр
ТАМИРЛАН	мр
ТАМРИКО	жр
ТАНГОЛИТА	жр
ТАНЕЛ	мр
ТАНЕЧКА	жр
ТАНЗИЛА	жр
ТАНЗИЛИЯ	жр
ТАНЗИЛЛА	жр
ТАНЗИЛЛЯ	жр
ТАНИО	мр
ТАНИСЛАВ	мр
ТАНЬКА	жр
ТАНЮША	жр
ТАНЯ	жр
ТАРАНА	жр
ТАРАС	мр
ТАРАСКА	жр
ТАРВО	мр
ТАРИГ	мр
ТАРИЕЛ	мр
ТАРИЕЛЬ	мр
ТАРИЙ	мр
ТАРИК	мр
ТАРИНА	жр
ТАРИСЛ	мр
ТАРИХ	мр
ТАРИЭЛ	мр
ТАРИЭЛЬ	мр
ТАРИЯН	мр
ТАРЛАН	мр
ТАРМО	мр
ТАРП	мр
ТАРХАН	мр
ТАТЬЯНА	жр
ТАТЬЯНКА	жр
ТАТЭВИК	мр
ТАТЯНА	жр
ТАУС	мр
ТАУФИК	мр
ТАФИГ	мр
ТАФИЛЯ	жр
ТАХИР	мр
ТАХИРА	жр
ТАХИРДЖАН	мр
ТАХИРДЖОН	мр
ТАХИРЖАН	мр
ТАХИРЖОН	мр
ТАХИРИ	мр
ТАХИРЯН	мр
ТАХМАСИБ	мр
ТАХМИНА	жр
ТАХТАР	мр
ТАЦИТ	мр
ТАШТАН	мр
ТАЯ	жр
ТЕД	мр
ТЕДВОРТ	мр
ТЕЙМРАЗ	мр
ТЕЙМУР	мр
ТЕЙМУРАЗ	мр
ТЕМИРБЕК	мр
ТЕМИРБУЛАТ	мр
ТЕМИРГАЛЕЙ	мр
ТЕНГИЗ	мр
ТЕНГИС	мр
ТЕОДОЗИЙ	мр
ТЕОДОЗИЯ	жр
ТЕОДОР	мр
ТЕОДОРА	жр
ТЕОДОРАС	мр
ТЕОДОРИЙ	мр
ТЕОДОРОС	мр
ТЕОДОСИЙ	мр
ТЕОДОСИЯ	жр
ТЕОФИЛИЯ	жр
ТЕОФИЛЬ	мр
ТЕРЕЗА	жр
ТЕРЕЗИЯ	жр
ТЕРЕНТИЙ	мр
ТЕРЕСА	жр
ТЕРЕСИЯ	жр
ТЕРИ	жр
ТЕРРИ	мр
ТЕЯ	жр
ТИБЕРИЙ	мр
ТИБОР	мр
ТИГРАН	мр
ТИДЖАНИ	мр
ТИИНА	жр
ТИИТ	мр
ТИМА	мр
ТИМЕРБАЙ	мр
ТИМЕРБУЛАТ	мр
ТИМЕРГАЛЕЙ	мр
ТИМЕРХАН	мр
ТИМОТИ	мр
ТИМОФЕЙ	мр
ТИМОША	мр
ТИМУР	мр
ТИМУРАЗ	мр
ТИМУРБЕК	мр
ТИМУРБУЛАТ	мр
ТИМУРЛАН	мр
ТИНАМАГОМЕД	мр
ТИОНИДА	жр
ТИТ	мр
ТИТУС	мр
ТИХОМИР	мр
ТИХОН	мр
ТИША	мр
ТОВИЙ	мр
ТОВСАРИ	жр
ТОДОС	мр
ТОДОСИЯ	жр
ТОЙБА	жр
ТОЙВА	жр
ТОЙВО	мр
ТОЙГОНБАЙ	мр
ТОЙИР	мр
ТОЙЛИ	мр
ТОЙНИ	мр
ТОЛЬЯНА	жр
ТОЛЯ	мр
ТОМ	мр
ТОМА	жр
ТОМАЗ	мр
ТОМАР	мр
ТОМАС	мр
ТОМАШ	мр
ТОМИЛА	жр
ТОМИЛЛА	жр
ТОМИСЛАВ	мр
ТОМИСЛАВА	жр
ТОМКА	жр
ТОММИ	мр
ТОНИ	мр
ТОНЯ	жр
ТООМАС	мр
ТОРГОМ	мр
ТОРГОН	мр
ТОСЯ	жр
ТОФИГ	мр
ТОФИК	мр
ТОФИР	мр
ТОФИЧ	мр
ТОША	мр
ТРИСТАН	мр
ТРИСТОН	мр
ТРИФИЛИЙ	мр
ТРИФОН	мр
ТРИША	мр
ТРОАДИЙ	мр
ТРОНГ	мр
ТРОНД	мр
ТРОФИМ	мр
ТРОЯН	мр
ТРУДОМИР	мр
ТРУДОСЛАВ	мр
ТУЙААРА	жр
ТУЛЕГЕН	мр
ТУЛЬМИРА	жр
ТУЛЬНАРА	жр
ТУНДЖАЙ	мр
ТУНЗАЛА	мр
ТУРАДЖ	мр
ТУРАТБЕК	мр
ТУРГУН	мр
ТУРЛУБЕК	мр
ТУРСУНБЕК	мр
ТУРСУНХАН	мр
ТУРЫС	мр
ТУСЯ	жр
ТУТСИ	жр
ТУФАН	мр
ТУХВАТУЛЛИН	мр
ТУЯНА	жр
ТХИ	мр
ТЫНИС	мр
ТЫНУ	мр
ТЬЕРРИ	мр
ТЭМУР	мр
ТЭО	жр
ТЭОНА	жр
ТЭРАНЭ	жр
ТЭРБИШ	жр
ТЭРЕСА	жр
ТЭЯ	жр
ТЮН	мр
ТЮНЯ	мр
УАЙТ	мр
УВАЙС	мр
УВГЕНИЙ	мр
УВЕ	мр
УВЕНАЛИЙ	мр
УГО	мр
УДО	мр
УЗАКБАЙ	мр
УИЛЛИАМ	мр
УИЛЬЯМ	мр
УИЛЬЯМС	мр
УИНСТОН	мр
УИНТЕР	мр
УЙГУН	мр
УЛВИ	жр
УЛВИЯ	жр
УЛИНА	жр
УЛИЯНИЯ	жр
УЛЛА	мр
УЛЛУБИЙ	мр
УЛУГБЕК	мр
УЛУКБЕК	мр
УЛУСБЕК	мр
УЛЬБРИХТ	мр
УЛЬВИ	жр
УЛЬМАС	мр
УЛЬРИХ	мр
УЛЬФАТ	мр
УЛЬЯН	мр
УЛЬЯНА	жр
УЛЯ	жр
УЛЯНА	жр
УМАЙСАТ	мр
УМАЛАТ	мр
УМАР	мр
УМАРАЛИ	мр
УМАРАСХАБ	мр
УМАРДЖОН	мр
УМАРЖАН	мр
УМАРЖОН	мр
УМАТГИРЕЙ	мр
УМЕРБЕК	мр
УМЕРДЖОН	мр
УМЕРЖАН	мр
УМЕРХАН	мр
УМИДА	жр
УМИРБЕК	мр
УМИРЗАК	мр
УМЯР	мр
УНА	жр
УОЛДРОН	мр
УОЛЛЕС	мр
УОЛТ	мр
УОЛТЕР	мр
УОРДЕН	мр
УОРРЕН	мр
УРАЛИЯ	жр
УРМАС	мр
УРМАТ	мр
УРМАТБЕК	мр
УРМИЛА	жр
УРС	мр
УРСУЛА	жр
УРУЗМАГ	мр
УРШУЛЯ	жр
УСАМА	мр
УСМАН	мр
УСМАНГАЛИ	мр
УСМАНДЖОН	мр
УСМАНЖАН	мр
УССАМА	мр
УСТИМ	мр
УСТИН	мр
УСТИНА	жр
УСТИНИЯ	жр
УСТИНЬЯ	жр
УСУБЕК	мр
УШЕР	мр
УЭСЛИ	мр
ФААЗ	мр
ФААТ	мр
ФАБИАН	мр
ФАБИО	мр
ФАБИЯН	мр
ФАБРИС	мр
ФАБРИЦИО	мр
ФАБЬЯН	мр
ФАВАД	мр
ФАВАЗ	мр
ФАВАРИС	мр
ФАВАСИМ	мр
ФАВДИЯ	жр
ФАВЕЛ	мр
ФАВЕЛЬ	мр
ФАВЕТА	жр
ФАВЗАВ	мр
ФАВЗИЯ	жр
ФАВИЙ	мр
ФАВИЛЬ	мр
ФАВИС	мр
ФАВРОНЬЯ	жр
ФАВСТ	мр
ФАВСТА	жр
ФАГАДА	жр
ФАГАНИ	мр
ФАГЕМ	мр
ФАГИЛ	мр
ФАГИЛА	жр
ФАГИЛИЯ	жр
ФАГИЛЬ	мр
ФАГИЛЬЯ	жр
ФАГИЛЯ	жр
ФАГИМ	мр
ФАГИМА	жр
ФАГИМЕ	жр
ФАГИМЯ	жр
ФАГИН	мр
ФАГИТ	мр
ФАГИЯ	жр
ФАГМАН	мр
ФАГРАД	мр
ФАГРАТ	мр
ФАДАГАТ	мр
ФАДАИЛ	мр
ФАДАЛ	мр
ФАДАН	мр
ФАДДЕЙ	мр
ФАДДИЙ	мр
ФАДЕЙ	мр
ФАДЕЛ	мр
ФАДЕЛЬ	жр
ФАДЗИЯ	жр
ФАДИ	мр
ФАДИЙ	мр
ФАДИК	мр
ФАДИЛ	мр
ФАДИЛА	жр
ФАДИЛЯ	жр
ФАДИМА	жр
ФАДИМЕ	мр
ФАДИН	мр
ФАДИР	мр
ФАДИТ	мр
ФАДИЯ	жр
ФАДЛИ	мр
ФАДМЕ	мр
ФАЕД	мр
ФАЕЗ	мр
ФАЕК	мр
ФАЖРУДИН	мр
ФАЗАИЛ	мр
ФАЗАИР	мр
ФАЗАЛ	мр
ФАЗИДИН	мр
ФАЗИЛ	мр
ФАЗИЛА	жр
ФАЗИЛАТ	мр
ФАЗИЛЖАН	мр
ФАЗИЛЬ	мр
ФАЗИЛЯ	жр
ФАЗИМА	жр
ФАЗИНА	жр
ФАЗИРА	жр
ФАЗЛЕТДИН	мр
ФАЗЛИДДИН	мр
ФАЗЛИДИН	мр
ФАЗМЕДДИН	мр
ФАЗЫЛ	мр
ФАИЗ	мр
ФАИЗРАХМАН	мр
ФАИК	мр
ФАИЛИЯ	жр
ФАИЛЬЯ	жр
ФАИЛЯ	жр
ФАИМ	мр
ФАИМА	жр
ФАИМЕ	жр
ФАИМЯ	жр
ФАИНА	жр
ФАИНЯ	жр
ФАИРУЗА	жр
ФАЙЗУЛЛА	мр
ФАЛИЛЕЙ	мр
ФАНДАС	мр
ФАНИДА	жр
ФАНИЗА	жр
ФАНИЙ	мр
ФАНИКА	жр
ФАНИЛ	мр
ФАНИЛИЯ	жр
ФАНИЛЬ	мр
ФАНИС	мр
ФАНИСА	жр
ФАНИСЯ	жр
ФАНИЯ	жр
ФАННИ	жр
ФАНУЗА	жр
ФАНУЗЕ	жр
ФАНУР	мр
ФАНЯ	жр
ФАРД	мр
ФАРДАНА	жр
ФАРДАНИЯ	жр
ФАРДУНЯ	жр
ФАРИД	мр
ФАРИДА	жр
ФАРИС	мр
ФАРИТ	мр
ФАРТОБЕЙ	мр
ФАРХАД	мр
ФАРХАДЖАН	мр
ФАРХАН	мр
ФАРХАТ	мр
ФАРХИД	мр
ФАРХИНУР	мр
ФАРХОД	мр
ФАРХОДЖАН	мр
ФАРХОДЖОН	мр
ФАРХУД	мр
ФАРХУТДИН	мр
ФАСТА	мр
ФАТЕЙ	мр
ФАТЕК	мр
ФАТЕМА	жр
ФАТЕХ	мр
ФАТЕХА	жр
ФАТИМА	жр
ФАТИНА	жр
ФАТИНИЯ	жр
ФАТИНЬЯ	жр
ФАТИХ	мр
ФАТИХА	жр
ФАТЫХ	мр
ФАУЗИЯ	жр
ФАХЕД	мр
ФАХИРЯ	жр
ФАХРАЗЕЙ	мр
ФАХРАТДИН	мр
ФАХРЕДДИН	мр
ФАХРЕДИН	мр
ФАХРЕТДИН	мр
ФАХРИДДИН	мр
ФАХРИДИН	мр
ФАХРИСЛАМ	мр
ФАХРИТДИН	мр
ФАХРОДДИН	мр
ФАХРУДДИН	мр
ФАХРУДИН	мр
ФАХРУТДИН	мр
ФАЯЗ	мр
ФЕВЗИЙ	мр
ФЕВЗИЯ	жр
ФЕВРАЛИНА	жр
ФЕВРАНИЯ	жр
ФЕВРОНИЯ	жр
ФЕВРОНЬЯ	жр
ФЕВРУСА	жр
ФЕДЕРИКО	мр
ФЕДЕЧКА	мр
ФЁДОР	мр
ФЕДОРА	жр
ФЕДОРИЙ	мр
ФЕДОРИНА	жр
ФЕДОРИЯ	жр
ФЕДОС	мр
ФЕДОСЕЙ	мр
ФЕДОСЕЯ	жр
ФЕДОСИЙ	мр
ФЕДОСИЯ	жр
ФЕДОСЬЯ	жр
ФЕДОТ	мр
ФЕДОТИЯ	жр
ФЕДОТЬЯ	жр
ФЕДУЛ	мр
ФЕДЬКА	мр
ФЕДЯ	мр
ФЕЙРУДИН	мр
ФЁКЛА	жр
ФЕКЛИНА	жр
ФЕКЛИНИЯ	жр
ФЕКЛИНЬЯ	жр
ФЕКЛИСТА	жр
ФЕКЛУША	жр
ФЕЛАНИЯ	жр
ФЕЛЕКС	мр
ФЕЛИКС	мр
ФЕЛИКСАС	мр
ФЕЛИКСИНА	жр
ФЕЛИСА	жр
ФЕЛИСАДА	жр
ФЕЛИСАТА	жр
ФЕЛИЦА	жр
ФЕЛИЦАТА	жр
ФЕЛИЦИАНА	жр
ФЕЛИЦИАТА	жр
ФЕЛИЦИТА	жр
ФЕЛИЦИЯ	жр
ФЕЛИЧИЯ	жр
ФЕЛИЯ	жр
ФЕЛОМЕНА	жр
ФЕЛОРА	жр
ФЕЛУРА	жр
ФЕЛЮРА	жр
ФЕНИК	мр
ФЕНИМОР	мр
ФЕНИЯ	жр
ФЕНОГЕН	мр
ФЕНЯ	жр
ФЕОДОРА	жр
ФЕОДОСИЙ	мр
ФЕОДОСЬЯ	жр
ФЕОДОТИЯ	жр
ФЕОКЛА	жр
ФЕОКТИСА	жр
ФЕОКТИСИЯ	жр
ФЕОКТИСТ	мр
ФЕОКТИСТА	жр
ФЕОНА	жр
ФЕОНИДА	жр
ФЕОНИЛА	жр
ФЕОНИНА	жр
ФЕОНИЯ	жр
ФЕОТИНЬЯ	жр
ФЕОФАН	мр
ФЕОФАНА	жр
ФЕОФАНИЙ	мр
ФЕОФАНИЯ	жр
ФЕОФАННА	жр
ФЕОФИЛ	мр
ФЕОФИЛА	жр
ФЕОФИЛАКТ	мр
ФЕОФИНИЯ	жр
ФЕОХАРИЙ	мр
ФЕРАПОНТ	мр
ФЕРАС	мр
ФЕРДАВИС	мр
ФЕРДАНИЯ	жр
ФЕРДАНЬЯ	жр
ФЕРДИНАНД	мр
ФЕРДИНАНДО	мр
ФЕРДИНАНТ	мр
ФЕРДОНИЯ	жр
ФЕРЕНЦ	мр
ФЕРЗАНИЯ	жр
ФЕРИКА	жр
ФЕРНАН	мр
ФЕРНАНДО	мр
ФЕРУЗ	мр
ФЕРХАД	мр
ФЕРХАТ	мр
ФЕРЮЗА	жр
ФЕТИНИЯ	жр
ФЕТИНЬЯ	жр
ФИАЛА	жр
ФИДЕЛИЯ	жр
ФИДЕЛЬ	мр
ФИКРАТ	мр
ФИКРЕТ	мр
ФИКРЯТ	мр
ФИЛ	мр
ФИЛАРЕТ	мр
ФИЛАТ	мр
ФИЛИГИЯ	жр
ФИЛИДА	жр
ФИЛИЙ	мр
ФИЛИМЕНА	жр
ФИЛИМОН	мр
ФИЛИМОНА	жр
ФИЛИП	мр
ФИЛИПИЯ	жр
ФИЛИПП	мр
ФИЛИППИНА	жр
ФИЛОМЕНА	жр
ФИЛОМИНА	жр
ФИЛОНИДА	жр
ФИЛОНИЛА	жр
ФИЛОРЕТ	мр
ФИЛОРЕТА	жр
ФИЛОТИЯ	жр
ФИЛЬЗА	жр
ФИЛЯ	мр
ФИЛЯРА	жр
ФИМА	мр
ФИМКА	жр
ФИНАРИЯ	жр
ФИНАТ	мр
ФИОНА	жр
ФИОНИЯ	жр
ФИОРЕНТИНО	мр
ФИРА	жр
ФИРАГАТ	мр
ФИРАД	мр
ФИРАДДИН	мр
ФИРАЗ	мр
ФИРАЗИЯ	жр
ФИРАИДА	жр
ФИРАНГИЗ	мр
ФИРАНИЯ	жр
ФИРАС	мр
ФИРАТ	мр
ФИРАУС	мр
ФИРАЯ	жр
ФИРИНАТ	мр
ФИРС	мр
ФИРУЗА	жр
ФИРУЗЕ	жр
ФИРУЗЯ	жр
ФИРУСА	жр
ФЛАВИАН	мр
ФЛАВИЙ	мр
ФЛАВИО	мр
ФЛАВИЯ	жр
ФЛЕГОНТ	мр
ФЛЕКС	мр
ФЛЕРА	жр
ФЛИДА	жр
ФЛОР	мр
ФЛОРА	жр
ФЛОРЕЛЛА	жр
ФЛОРЕНСА	жр
ФЛОРЕНТИНА	жр
ФЛОРИАН	мр
ФЛОРИАНА	жр
ФЛОРИАННА	жр
ФЛОРИЙ	мр
ФЛОРИНА	жр
ФЛОРИС	мр
ФЛОРИСА	жр
ФЛУРИЯ	жр
ФЛЮЗА	жр
ФЛЮЗЯ	жр
ФЛЮН	мр
ФЛЮР	мр
ФЛЮРА	жр
ФЛЮРИДА	жр
ФЛЮСА	жр
ФЛЮСЯ	жр
ФОКА	мр
ФОКИЙ	мр
ФОЛЬКЕР	мр
ФОМА	мр
ФОТИЙ	мр
ФОТИНА	жр
ФОТИНЬЯ	жр
ФРАГОНАР	мр
ФРАНГИЗ	мр
ФРАНИС	мр
ФРАНС	мр
ФРАНСИС	мр
ФРАНСУА	мр
ФРАНСУАЗА	жр
ФРАНТИШЕК	мр
ФРАНЦ	мр
ФРАНЦ-ИОСИФ	мр
ФРАНЦИЗА	жр
ФРАНЦИСК	мр
ФРАНЦИШЕК	мр
ФРАНЧЕСКА	жр
ФРАНЧЕСКО	мр
ФРАНЧИШКО	мр
ФРАНЯ	жр
ФРЕД	мр
ФРЕДА	жр
ФРЕДДИ	мр
ФРЕДЕРИК	мр
ФРЕДЕРИКА	жр
ФРЕДЕРИКО	мр
ФРЕДИ	мр
ФРЕДИК	мр
ФРЕДИСЛАВ	мр
ФРЕДРИК	мр
ФРИД	мр
ФРИДА	жр
ФРИДЕЛЬ	мр
ФРИДЕН	мр
ФРИДЕРИКА	жр
ФРИДЖЕРИО	мр
ФРИДРИХ	мр
ФРИМА	жр
ФРИММА	жр
ФРИНА	жр
ФРОЛ	мр
ФРОСИНА	жр
ФРОСИНЬЯ	жр
ФРОСЯ	жр
ФРУЗЯ	жр
ФРЭНК	мр
ФРЭНСИС	мр
ФУАД	мр
ФУАР	мр
ФУАТ	мр
ФУРАТ	мр
ФЯВЗИЯ	жр
ФЯРУЗА	жр
ХАБИБ	мр
ХАБИБРАХМАН	мр
ХАБИБУЛАТ	мр
ХАБИБУЛАХ	мр
ХАБИБУЛЛ	мр
ХАБИБУЛЛА	мр
ХАБИБУЛЛАХ	мр
ХАВАР	мр
ХАВРА	жр
ХАВРОНИЯ	жр
ХАВРОНЬЯ	жр
ХАВСЯ	жр
ХАВЬЕР	мр
ХАДЕР	мр
ХАДЖИБАЙ	мр
ХАДЖИМУРАТ	мр
ХАДЖИМУРЗА	мр
ХАДЖИМУХАМЕД	мр
ХАДИС	мр
ХАЗАЛ	мр
ХАЗАН	мр
ХАЗАНГЮЛЬ	жр
ХАЗАНИ	мр
ХАЗЕМ	мр
ХАЗИАХМЕТ	мр
ХАИМ	мр
ХАИТБАЙ	мр
ХАЙДАР	мр
ХАЙРЕТДИН	мр
ХАЙРЕТТИН	мр
ХАЙРУЛЛ	мр
ХАКИМ	мр
ХАЛБАЙ	мр
ХАЛЕД	мр
ХАЛЕДДИН	мр
ХАЛЕЗА	мр
ХАЛИД	мр
ХАЛИДА	жр
ХАЛИК	мр
ХАЛИКНАЗАР	мр
ХАЛИЛ	мр
ХАЛИЛЬ	мр
ХАЛИМ	мр
ХАЛИМА	жр
ХАЛИПАТ	мр
ХАЛИСА	мр
ХАЛИТ	мр
ХАЛИУЛЛА	мр
ХАЛЫКБЕРДЫ	мр
ХАМАТ	жр
ХАМДИЯ	жр
ХАМЕД	мр
ХАМЕТ	мр
ХАМЗА	мр
ХАМЗАЙ	мр
ХАМЗАТ	мр
ХАМИД	мр
ХАМИЛЬ	мр
ХАМИТ	мр
ХАМЛЕТ	мр
ХАМУ	мр
ХАМУД	мр
ХАМУЛА	мр
ХАМУРЗА	мр
ХАНА	жр
ХАНАЛИ	мр
ХАНАН	мр
ХАНАФИ	мр
ХАНИ	мр
ХАРИС	мр
ХАРИТИНА	жр
ХАРИТОН	мр
ХАРИТОНА	жр
ХАРИТОНИЯ	жр
ХАРЛАМИЙ	мр
ХАРЛАМП	мр
ХАРЛАМПИЙ	мр
ХАРОЛЬД	мр
ХАРРИ	мр
ХАРРИС	мр
ХАРРИЯ	жр
ХАСАН	мр
ХАСАНА	жр
ХАСАНБ	мр
ХАСАНБАЙ	мр
ХАСАНБЕК	мр
ХАСАНЯ	жр
ХАСБУЛАТ	мр
ХАСИМА	жр
ХАСИНА	жр
ХАСИЯ	жр
ХАССАН	мр
ХАСЯ	жр
ХАСЯН	мр
ХАТАМ	мр
ХАТЕМ	мр
ХАТИБ	мр
ХАТИДЖЕ	жр
ХАТИМАТ	жр
ХАТИЧЕ	жр
ХАТИЯ	жр
ХАТМУЛЛА	мр
ХАТТАБ	мр
ХАТУ	мр
ХАТУНА	жр
ХАУА	мр
ХАФИЗ	мр
ХАЧИК	мр
ХАЧИМ	мр
ХАШИМ	мр
ХАЯ	жр
ХАЯЛА	мр
ХЕЙДО	мр
ХЕЛЕНА	жр
ХЕЛИН	жр
ХЕЛИНА	жр
ХЕЛЬГА	жр
ХЕЛЬГЕ	жр
ХЕЛЬДУР	мр
ХЕЛЬМУТ	мр
ХЕНДРИК	мр
ХЕНРИ	мр
ХЕНРИК	мр
ХЕНРИКАС	мр
ХЕНРИХ	мр
ХЕРБЕРТ	мр
ХЕРЛИ	мр
ХЕРМАН	мр
ХЕРТА	жр
ХИБЛА	жр
ХИВОНИЯ	жр
ХИЖА	жр
ХИКМАТ	мр
ХИКМЕТ	мр
ХИЛАРИ	жр
ХИМЕНЕС	мр
ХИМИУС	мр
ХИМЬЯНА	жр
ХЛОЙЯ	жр
ХЛОНИЯ	жр
ХЛОРА	жр
ХОДЖА	мр
ХОДСОН	мр
ХОЗЕ	мр
ХОЛИСА	мр
ХОМА	мр
ХОРЕН	мр
ХОСЕ	мр
ХОСНИ	мр
ХОССЕЙН	мр
ХРИСАНФ	мр
ХРИСТИАНА	жр
ХРИСТИНА	жр
ХРИСТИНИЯ	жр
ХРИСТИНЬЯ	жр
ХРИСТИЯ	жр
ХРИСТИЯН	мр
ХРИСТОФ	мр
ХРИСТОФОР	мр
ХРИСТЬЯН	мр
ХРИСТЯ	жр
ХУАН	мр
ХУБЕРТ	мр
ХУБЕРТУС	мр
ХУДОБЕРДЫ	мр
ХУЛИО	мр
ХУСАИН	мр
ХУСЕЙН	мр
ХУСИН	мр
ХУССЕЙН	мр
ХУСТО	мр
ХУСЯИН	мр
ХУШНУДБЕК	мр
ХЬО	мр
ХЬЮ	мр
ХЬЮГО	мр
ХЬЮН	мр
ЦАГААН	мр
ЦАГИК	мр
ЦАЙ	мр
ЦАЙПИН	мр
ЦАЙСЯ	мр
ЦАЦГАЙ	мр
ЦВЕТА	жр
ЦВЕТАНА	жр
ЦВЕТАНКА	жр
ЦВЕТЕЛИНА	жр
ЦВЕТЛАНА	жр
ЦВЕТТА	жр
ЦЕЗАР	мр
ЦЕЗАРИ	мр
ЦЕЗАРИЙ	мр
ЦЕЗАРИНА	жр
ЦЕЗАРИЯ	жр
ЦЕЗЕРИНА	жр
ЦЕЛЕСТИНА	жр
ЦЕЛИСТИНА	жр
ЦЕСЛАВА	жр
ЦЕТКИН	жр
ЦЕЦИЛИЯ	жр
ЦЗЯН	мр
ЦИЛЯ	жр
ЦИНТИЯ	жр
ЦИЦЕРОН	мр
ЦИЦИЛИЯ	жр
ЦИЦИНА	жр
ЦОЛАК	мр
ЦЫЛЯ	жр
ЦЫРА	жр
ЧАК	мр
ЧАРЛИ	мр
ЧАРЛЬЗ	мр
ЧЕРВОНЯ	жр
ЧЕРКЕЗ	мр
ЧЕСЛАВ	мр
ЧЕСЛАВА	жр
ЧЕЧИЛИЯ	жр
ЧИГИЛИЯ	жр
ЧИК	мр
ЧИЛИТА	жр
ЧИНГИЗ	мр
ЧИНГИЗХАН	мр
ЧИНГИС	мр
ЧИНГИСХАН	мр
ЧИНКИЗ	мр
ЧИОНГ	мр
ЧИСЛАВ	мр
ЧИСЛАВА	жр
ЧИСТОСЛАВ	мр
ЧИЧИЛИЯ	жр
ЧУЛПАН	жр
ШАБАД	мр
ШАБАДДИН	мр
ШАБАН	мр
ШАВКАТ	мр
ШАГИМАРДАН	мр
ШАГИН	мр
ШАИД	мр
ШАИН	мр
ШАЙБЕК	мр
ШАЙДАБЕГ	мр
ШАЙДУЛЛА	мр
ШАЙМИ	мр
ШАК	мр
ШАКАРБЕК	мр
ШАКЕД	жр
ШАКИР	мр
ШАККУМ	мр
ШАКЛА	мр
ШАЛАЛА	мр
ШАЛВА	жр
ШАМАЛ	мр
ШАМАЛА	жр
ШАМБУЛАТ	мр
ШАМГУН	мр
ШАМДИН	мр
ШАМЕДДИН	мр
ШАМЕДИН	мр
ШАМИЛ	мр
ШАМИЛЬ	мр
ШАМСИ	жр
ШАМСИНУР	жр
ШАМСИЯ	жр
ШАМШИЯ	жр
ШАМЬЯНА	жр
ШАНА	жр
ШАНДР	мр
ШАНЕТТА	жр
ШАНИЯ	жр
ШАННА	жр
ШАРАФ	мр
ШАРАФАДДИН	мр
ШАРАФАДИН	мр
ШАРАФАТДИН	мр
ШАРАФЕДДИН	мр
ШАРАФЕДИН	мр
ШАРИП	мр
ШАРИФ	мр
ШАРИФЗЯН	мр
ШАРИФУЛ	мр
ШАРИФУЛА	мр
ШАРИФУЛЛА	мр
ШАРИФЧОН	мр
ШАРИФЬЯН	мр
ШАРИФЯН	мр
ШАРЛОТА	жр
ШАРЛОТТА	жр
ШАРЛЬ	мр
ШАРО	мр
ШАРОФИДИН	мр
ШАУЛЬ	мр
ШАФГАТ	мр
ШАФИК	мр
ШАХАН	мр
ШАХБАЛА	мр
ШАХВЕРДИ	мр
ШАХЗАД	мр
ШАХЛА	жр
ШАХМАМЕД	мр
ШАХМУРАД	мр
ШАХМУРАТ	мр
ШАХНОЗА	жр
ШАХРИ	мр
ШАХРИЯР	мр
ШЕВА	жр
ШЕВКЕТ	мр
ШЕЙЛА	жр
ШЕЛЛИ	мр
ШЕННОН	мр
ШЕРИГ-ООЛ	мр
ШЕРЛОК	мр
ШИГАБ	мр
ШИГАП	мр
ШИМОН	мр
ШИРАК	мр
ШИРИН	жр
ШИХБАЛА	мр
ШИХКЕРИМ	мр
ШИХМАГОМЕД	мр
ШИХМАМЕД	мр
ШИХМУРАД	мр
ШЛОМО	мр
ШОД	мр
ШОИРА	жр
ШОЛОМ	мр
ШОН	мр
ШОРЕНА	жр
ШОТА	мр
ШОХЗОД	мр
ШУКУР	мр
ШУРА	жр
ШУРИК	мр
ШУРКА	жр
ШУРОЧКА	жр
ШУХРАТ	мр
ШУШАНА	жр
ШУШАНИК	мр
ШУШАНИКА	жр
ШУШАННА	жр
ЭБЕРГАРД	мр
ЭБЕРХАРД	мр
ЭБОЛА	мр
ЭВАЛД	мр
ЭВАЛДАС	мр
ЭВАЛДИК	мр
ЭВАЛИНА	жр
ЭВАЛЬД	мр
ЭВАЛЬДАС	мр
ЭВАЛЬТ	мр
ЭВАН	жр
ЭВАНГЕЛИНА	жр
ЭВАРЕСТ	мр
ЭВГЕНИЙ	мр
ЭВГЕНИЯ	жр
ЭВЕЛИНА	жр
ЭВЕТА	жр
ЭВЕТТА	жр
ЭВИ	жр
ЭВИЛИНА	жр
ЭВИТА	жр
ЭВИЯ	жр
ЭВОЛЬД	мр
ЭВОЛЬТ	мр
ЭВРИДИКА	жр
ЭВХАН	мр
ЭГЕДИЙ	мр
ЭГИДИЮС	мр
ЭГОН	мр
ЭДА	жр
ЭДВАРД	мр
ЭДВАРДА	жр
ЭДВАРДАС	мр
ЭДВАРДОС	мр
ЭДВИН	мр
ЭДВИНА	жр
ЭДВИНАС	мр
ЭДВИНС	мр
ЭДГАР	мр
ЭДГАРД	мр
ЭДГАРС	мр
ЭДГАРТ	мр
ЭДДА	жр
ЭДДИ	мр
ЭДЕН	мр
ЭДИК	мр
ЭДИП	мр
ЭДИТА	жр
ЭДИТТА	жр
ЭДИЯТ	мр
ЭДМОНД	мр
ЭДМУНД	мр
ЭДМУНДАС	мр
ЭДМУНДО	мр
ЭДМУНДС	мр
ЭДРИАН	мр
ЭДУАРД	мр
ЭДУАРДА	жр
ЭДУАРДАС	мр
ЭДУАРДО	мр
ЭЖДЕР	мр
ЭЖЕН	мр
ЭЖЕНИ	жр
ЭЗОП	мр
ЭЙДЯ	мр
ЭЙЖЕН	мр
ЭЙНО	мр
ЭКАТЕРИНА	жр
ЭЛАН	мр
ЭЛБАЙ	мр
ЭЛВАРД	мр
ЭЛВИН	мр
ЭЛВИРА	жр
ЭЛВИС	мр
ЭЛВИСА	жр
ЭЛГИН	мр
ЭЛДАРИ	жр
ЭЛЕАНОРА	жр
ЭЛЕВИНА	жр
ЭЛЕВТИНА	жр
ЭЛЕДИНА	жр
ЭЛЕКОНИДА	жр
ЭЛЕКТРА	жр
ЭЛЕКТРИНА	жр
ЭЛЕМИР	мр
ЭЛЕНА	жр
ЭЛЕНЕ	жр
ЭЛЕНИ	жр
ЭЛЕННА	жр
ЭЛЕНОРА	жр
ЭЛЕНТИНА	жр
ЭЛЕНЭ	жр
ЭЛЕОНАРА	жр
ЭЛЕОНАРД	мр
ЭЛЕОНОР	жр
ЭЛЕОНОРА	жр
ЭЛЕОРИНА	жр
ЭЛЕТОР	мр
ЭЛЕТОРА	жр
ЭЛЕФТИНА	жр
ЭЛИ	мр
ЭЛИА	мр
ЭЛИАДА	жр
ЭЛИАЗАР	мр
ЭЛИАН	мр
ЭЛИАНА	жр
ЭЛИАНОРА	жр
ЭЛИАС	мр
ЭЛИАХУ	мр
ЭЛИАШ	мр
ЭЛИБЕК	мр
ЭЛИДИЯ	жр
ЭЛИЕЗЕР	мр
ЭЛИЗ	жр
ЭЛИЗА	жр
ЭЛИЗАБЕТА	жр
ЭЛИЗАБЕТТА	жр
ЭЛИЗАВЕТА	жр
ЭЛИКАНИДА	жр
ЭЛИМА	жр
ЭЛИМИР	мр
ЭЛИНА	жр
ЭЛИНАР	жр
ЭЛИННА	жр
ЭЛИНОР	жр
ЭЛИОДОРА	жр
ЭЛИОНАРДА	жр
ЭЛИОНОРА	жр
ЭЛИРА	жр
ЭЛИС	жр
ЭЛИСА	жр
ЭЛИСО	жр
ЭЛИСОН	жр
ЭЛИФЕРИЙ	мр
ЭЛЛА	жр
ЭЛЛАЗ	мр
ЭЛЛАИДА	жр
ЭЛЛАН	мр
ЭЛЛАНА	жр
ЭЛЛАНОРА	жр
ЭЛЛАР	мр
ЭЛЛЕОНОРА	жр
ЭЛЛЕР	мр
ЭЛЛИ	жр
ЭЛЛИАДА	жр
ЭЛЛИАНА	жр
ЭЛЛИАНОРА	жр
ЭЛЛИДА	жр
ЭЛЛИЙ	мр
ЭЛЛИНА	жр
ЭЛЛИОНОРА	жр
ЭЛЛИС	жр
ЭЛЛИСА	жр
ЭЛЛИСОН	мр
ЭЛЛИТА	жр
ЭЛЛИЯ	жр
ЭЛЛОДИЯ	жр
ЭЛЛОИДА	жр
ЭЛЛОНА	жр
ЭЛЛЯ	жр
ЭЛНАРА	жр
ЭЛНУР	жр
ЭЛОИЗА	жр
ЭЛОНА	жр
ЭЛТОН	мр
ЭЛУИЗА	жр
ЭЛЧИН	мр
ЭЛШАН	мр
ЭЛЬБАЙ	мр
ЭЛЬБЕРТИНА	жр
ЭЛЬВА	жр
ЭЛЬВЕРА	жр
ЭЛЬВЕРИНА	жр
ЭЛЬВИДА	жр
ЭЛЬВИНА	жр
ЭЛЬВИРА	жр
ЭЛЬВИТТА	жр
ЭЛЬВИЯ	жр
ЭЛЬГА	жр
ЭЛЬГАР	мр
ЭЛЬДА	жр
ЭЛЬДАНИЗ	мр
ЭЛЬДАР	мр
ЭЛЬДАРИ	жр
ЭЛЬДАТ	мр
ЭЛЬДАУ	жр
ЭЛЬДЕНИЗ	мр
ЭЛЬДЕР	мр
ЭЛЬДЕРХАН	мр
ЭЛЬДЖАН	мр
ЭЛЬДИН	мр
ЭЛЬДИНА	жр
ЭЛЬДИЯ	жр
ЭЛЬДИЯР	мр
ЭЛЬДОНИЗ	мр
ЭЛЬДОР	мр
ЭЛЬЖБЕТА	жр
ЭЛЬЖБЕТТА	жр
ЭЛЬЖБИТА	жр
ЭЛЬЗА	жр
ЭЛЬЗАМ	мр
ЭЛЬЗАНА	жр
ЭЛЬЗАР	мр
ЭЛЬЗАРА	жр
ЭЛЬЗИДА	жр
ЭЛЬМА	жр
ЭЛЬМАЗ	мр
ЭЛЬМАН	мр
ЭЛЬМАР	мр
ЭЛЬМАРА	жр
ЭЛЬМАРТ	мр
ЭЛЬМАС	мр
ЭЛЬМИНА	жр
ЭЛЬМИР	мр
ЭЛЬМИРА	жр
ЭЛЬНА	жр
ЭЛЬНАРА	жр
ЭЛЬНИРА	жр
ЭЛЬНОРА	жр
ЭЛЬНУР	мр
ЭЛЬНУРА	жр
ЭЛЬОНОРА	жр
ЭЛЬПИДА	жр
ЭЛЬФЕР	мр
ЭЛЬФИНА	жр
ЭЛЬФИРА	жр
ЭЛЬФИС	мр
ЭЛЬФИЯ	жр
ЭЛЬФРЕДА	жр
ЭЛЬФРИДА	жр
ЭЛЬХАН	мр
ЭЛЬХАП	мр
ЭЛЬЧИБЕЙ	мр
ЭЛЬЧИН	мр
ЭЛЬШАН	мр
ЭЛЬЯНА	жр
ЭЛЬЯНОРА	жр
ЭЛЬЯС	мр
ЭЛЯ	жр
ЭМА	жр
ЭМАЛИЯ	жр
ЭМАНУИЛ	мр
ЭМАНУЭЛА	жр
ЭМАНУЭЛЛА	жр
ЭМАНУЭЛЬ	жр
ЭМБА жр
ЭМЕРИХ	мр
ЭМИЛ	мр
ЭМИЛА	жр
ЭМИЛИ	жр
ЭМИЛИА	жр
ЭМИЛИАН	мр
ЭМИЛИАНА	жр
ЭМИЛИЙ	мр
ЭМИЛИО	мр
ЭМИЛИТА	жр
ЭМИЛИЯ	жр
ЭМИЛЬ	мр
ЭМИН	мр
ЭМИНА	жр
ЭМИРБЕК	мр
ЭМИРСУЛТАН	мр
ЭММА	жр
ЭММАЛИНА	жр
ЭММАЛИЯ	жр
ЭММАНУИЛ	мр
ЭММАНУИЛА	жр
ЭММАНУЭЛА	жр
ЭММАНУЭЛЛА	жр
ЭММАНУЭЛЬ	жр
ЭММЕРИТА	жр
ЭММИЛИЯ	жр
ЭМОМАЛИ	мр
ЭМОНОРА	жр
ЭМРЕ	мр
ЭМФИРА	жр
ЭМФРИДА	жр
ЭНВЕР	мр
ЭНГЕЛИНА	жр
ЭНГЕЛИСА	жр
ЭНГЕЛИЯ	жр
ЭНГЕЛЬС	мр
ЭНГЕЛЬСИНА	жр
ЭНГЕМ	мр
ЭНГИЛИНА	жр
ЭНДЖЕ	жр
ЭНДИ	мр
ЭНДРЮ	мр
ЭНЕЛИНА	жр
ЭНН	жр
ЭННА	жр
ЭННАН	мр
ЭННЕЛЬ	жр
ЭННЕСА	жр
ЭННЕССА	жр
ЭННЕТА	жр
ЭННИ	жр
ЭНРИКЕ	мр
ЭНРИКО	мр
ЭНТОНИ	мр
ЭНЭЛИЯ	жр
ЭРАЗМ	мр
ЭРАН	мр
ЭРАСТ	мр
ЭРВИН	мр
ЭРВИНА	жр
ЭРГАРТ	мр
ЭРЖИКА	жр
ЭРИЙ	мр
ЭРИК	мр
ЭРИКАС	мр
ЭРИКНАЗ	мр
ЭРИКО	мр
ЭРИКОС	мр
ЭРИКС	мр
ЭРИКСОН	мр
ЭРИХ	мр
ЭРКАИМ	жр
ЭРКАН	мр
ЭРКИБАЙ	мр
ЭРКИН	мр
ЭРКИНА	жр
ЭРКИНБАЙ	мр
ЭРКИНЖАН	мр
ЭРКИНЖОН	мр
ЭРКИЯ	мр
ЭРЛАН	мр
ЭРЛАНД	мр
ЭРЛАНДА	жр
ЭРЛАНДАС	мр
ЭРЛЕН	мр
ЭРЛЕНД	мр
ЭРНА	жр
ЭРНАН	мр
ЭРНАНДЕС	мр
ЭРНАСТИНА	жр
ЭРНЕСТ	мр
ЭРНЕСТА	жр
ЭРНЕСТАС	мр
ЭРНЕСТИНА	жр
ЭРНЕСТО	мр
ЭРНЕСТР	мр
ЭРНИСТИНА	жр
ЭРНСТ	мр
ЭСМЕРАЛЬДА	жр
ЭСМИРА	жр
ЭСТЕЛЛА	жр
ЭСТЕР	жр
ЭСТЕРА	мр
ЭСФИРА	жр
ЭСФИРЬ	жр
ЭТЕЛ	жр
ЭТЕЛА	жр
ЭТЕЛИНА	жр
ЭТЕЛЛА	жр
ЭТЕЛЬ	жр
ЭТЕРА	жр
ЭТЕРИ	мр
ЭТЕРИЯ	жр
ЭТИЛИЯ	жр
ЭТИЛЬДА	жр
ЭТИНА	жр
ЭТЛИНА	жр
ЭТЛЯ	жр
ЭТЬЕН	мр
ЭФАЛИЯ	жр
ЭФРАИМ	мр
ЭФРОСИНЬЯ	жр
ЭФФАЛИЯ	жр
ЭХАБ	мр
ЭХАТ	мр
ЭХУД	мр
ЭШЛИ	мр
ЮВЕНАЛИЙ	мр
ЮВИНАЛИЙ	мр
ЮГАНИЯ	жр
ЮГИНА	жр
ЮДЖИН	мр
ЮДИТА	жр
ЮДИФЬ	жр
ЮЗЕФ	мр
ЮЗЕФА	жр
ЮЗЕФИЙ	мр
ЮЗЕФИНА	жр
ЮЗЕФИЯ	жр
ЮЛАНА	жр
ЮЛАННА	жр
ЮЛАНТА	жр
ЮЛДАШ	мр
ЮЛДУЗ	жр
ЮЛДУЗА	жр
ЮЛДУС	мр
ЮЛЕНЬКА	жр
ЮЛИ	мр
ЮЛИА	жр
ЮЛИАН	мр
ЮЛИАНА	жр
ЮЛИАНИЯ	жр
ЮЛИАННА	жр
ЮЛИДИЯ	жр
ЮЛИЗА	жр
ЮЛИЙ	мр
ЮЛИК	мр
ЮЛИКА	жр
ЮЛИНА	жр
ЮЛИННА	жр
ЮЛИСА	жр
ЮЛИТА	жр
ЮЛИТТА	жр
ЮЛИЯ	жр
ЮЛИЯН	мр
ЮЛИЯНА	жр
ЮЛЬКА	жр
ЮЛЬЯНА	жр
ЮЛЬЯННА	жр
ЮЛЯ	жр
ЮЛЯНА	жр
ЮНА	жр
ЮНАТА	жр
ЮНЕЛЬ	мр
ЮНЕССА	жр
ЮНЕТА	жр
ЮНИАНА	жр
ЮНИОНА	жр
ЮНИС	мр
ЮНИЯ	жр
ЮННА	жр
ЮНОНА	жр
ЮНОННА	жр
ЮНУС	мр
ЮНЯ	жр
ЮРА	мр
ЮРАТА	жр
ЮРГЕН	мр
ЮРГИС	мр
ЮРГИТА	жр
ЮРИ	мр
ЮРИАННА	жр
ЮРИЙ	мр
ЮРИЙНА	жр
ЮРИК	мр
ЮРИНА	жр
ЮРИС	мр
ЮРИСЛАВ	мр
ЮРИСЛАМ	мр
ЮРИЦ	мр
ЮРИЧ	мр
ЮРИЮС	мр
ЮРКА	мр
ЮРНИЙ	мр
ЮРЧИК	мр
ЮСЕФ	мр
ЮСИФ	мр
ЮСТИНА	жр
ЮСТИНИАН	мр
ЮСТИНИЯ	жр
ЮСТИНЬЯ	жр
ЮСУБ	мр
ЮСУП	мр
ЮСУПАЛИ	мр
ЮСУФ	мр
ЮТА	жр
ЮТАН	мр
ЯАННА	жр
ЯВДОКИЯ	жр
ЯВДОХА	жр
ЯГО	мр
ЯДВИГА	жр
ЯДВИНА	жр
ЯДГАР	мр
ЯЗГУЛЬ	жр
ЯЗМУРАД	мр
ЯЗМУРАТ	мр
ЯИНА	жр
ЯИР	мр
ЯКИМ	мр
ЯКОБ	мр
ЯКОВ	мр
ЯКУБ	мр
ЯКУШ	мр
ЯКУША	жр
ЯЛГИН	мр
ЯЛМАЗ	мр
ЯН	мр
ЯНА	жр
ЯНАКИЙ	мр
ЯНАТА	жр
ЯНВАРИНА	жр
ЯНЕТА	жр
ЯНЕТТА	жр
ЯНИАНА	жр
ЯНИК	мр
ЯНИКА	жр
ЯНИНА	жр
ЯНИННА	жр
ЯНИС	мр
ЯНИСА	жр
ЯНИСЛАВ	мр
ЯНИСЛАВА	жр
ЯНИТА	жр
ЯНИЯ	жр
ЯНКА	жр
ЯНКЕЛЬ	мр
ЯННА	жр
ЯННИК	мр
ЯННИНА	жр
ЯННИС	мр
ЯНОШ	мр
ЯНСЫЛУ	жр
ЯНУАРА	жр
ЯНУАРИЙ	мр
ЯНУАРИЯ	жр
ЯНУС	мр
ЯНУШ	мр
ЯРАСЛАВ	мр
ЯРЕМА	мр
ЯРИК	мр
ЯРИНА	жр
ЯРОМИР	мр
ЯРОН	мр
ЯРОПОЛК	мр
ЯРОСДАВ	мр
ЯРОСЛАВ	мр
ЯРОСЛАВА	жр
ЯРОСЛАВИЯ	жр
ЯРУЛЛА	мр
ЯСЕР	мр
ЯСЕРА	жр
ЯСИК	мр
ЯСИН	мр
ЯСИР	мр
ЯСЛИНА	жр
ЯСМИНА	жр
ЯСОН	мр
ЯССА	жр
ЯССЕР	мр
ЯСЬ	мр
ЯСЯ	жр
ЯТИМ	мр
ЯУДАТ	мр
ЯХА	жр
ЯХЕБЕК	мр
ЯЦЕК	мр
ЯЧЕСЛАВ	мр
ЯША	мр
ЯШАР	мр
ЯЭЛЬ	жр
КРИШНА	мр
ДЖИММИ	мр
ОЛЕСЯ	жр
МЕЛ	мр
ПИЛ	мр
НИК	мр
КОНФУЦИЙ	мр
ДЖОВАННИ	мр
ЭВРИСФЕЙ	мр
ХИЛЛАРИ	жр
НЭНСИ	жр
ПАВЛУША	мр
ЛЮСИ	жр
АМЕЛИ	жр
ЛЮЦИФЕР	мр
ТОМЕК	мр
ЛОРЕНЦО	мр
СЬЮЗИ	жр
ТИМ	мр
ЛЬЮИС	мр
МЭТТ	мр
ПАБЛО	мр
КАТЮША	жр
СИД	мр
ДЭН	мр
ПЕГГИ	жр
ДЖЕРРИ	мр
ЛАРС	мр
ВИВИАН	жр
ГРЕГ	мр
КРИШТИАНУ	мр
МАГНУС	мр
БЕНУА	мр
НАОТО	мр
ТЕДДИ	мр
БИЛЛИ	мр
ТЭДДИ	мр
ОЛИМПИАДА	жр
ТИНА	жр
ЛЮК	мр
ХЕЛЕНЕ	жр
САМИ	мр
СЮЗАННЕ	жр
ВЕСЕЛИН	мр
СИМОНЕ	жр
САНТЬЯГО	мр
НАПОЛЕОН	мр
